t3_jyom7w	Recount off to a slow start, especially in Milwaukee where Trump campaign observers object to thousands of ballots, envelopes	1
t3_jzpowr	Let's hear it for the judges for dismissing Trump's lawsuits	1
t3_jz0fch	Senators push to stop Trump administration's proposed arms sale to UAE	5
t3_jznb23	How Trump placed a ticking time bomb at the center of our system	7
t3_jzwtwx	What Donald Trump Liked About Being President	u
t3_jywaur	3 'dead' Georgia voters in fact very much alive: Trump, Tucker Carlson get it wrong	1
t3_jyxl4z	Trump ally, former NJ governor Chris Christie: president's election fraud claims are a 'national embarrassment'	1,7
t3_jzukkw	Almost no Trump voters consider Biden the legitimate 2020 election winner, poll says	1
t3_k05eu0	Trump lawsuit confuses Michigan and Minnesota locations in affidavit claiming voter fraud	1
t3_jyuup3	Trump Wonders Why Joe Biden Is Forming A Cabinet In Latest Tweet Screed	3
t3_jybo0y	Yes, Donald Trump claimed fraud after the 2016 Iowa caucuses	1
t3_jy06aa	After Trump meeting, Michigan GOP lawmakers say they're not aware of any info that would change Biden's victory in state	1
t3_jzx7gy	Rush Limbaugh knocks Trump's legal team: They promised 'bombshells' at press conference and 'nothing happened'	1,7
t3_jxou52	GOP Sens. Romney and Sasse condemn Trump's election challenges, "We are a nation of laws, not tweets"	1,7
t3_jz0nbc	Pressure grows from GOP for Trump to recognize Biden election win	1,3
t3_k0ei4s	Dan Bongino hints at potential run for president in 2024 if Larry Hogan runs and no Trump does	u
t3_jzfpm4	Trump set on veto of defense bill over renaming bases honoring Confederates	u
t3_jyl85p	Judge Dismisses Trump Campaign Suit to Invalidate PA Election Certification With Prejudice	1
t3_jzuvjc	Trump Administration Begins Transition Process	3
t3_jz7lhm	Edward Norton tears into 'whiny, sulky, petulant, Grinchy, vindictive' Donald Trump in pointed, poker-laced Twitter thread	7
t3_jyy5hi	Trump, the Saboteur. First a Tantrum, Then Taking Every Opportunity to Trash Our Government	7
t3_jyy8fq	Biden to name first Cabinet picks Tuesday, as Trump bemoans swift actions	3
t3_jzqrf3	Bernstein names 21 Republican senators who privately expressed contempt for Trump	7
t3_jywmds	Split-screen: Biden preps to be president, Trump fights for the job he is ignoring	3,7
t3_jz81tt	Trump lashes out at fellow Republicans as his legal challenges to election results fail	1
t3_jzjptq	Two-thirds of GOP voters support Trump running for president in 2024: survey	u
t3_jzk58s	Trump has tested the limits of the US constitution  but it's still holding	7
t3_jzicmc	How Ronald Reagan's Racism Helped Pave the Way for Donald Trump's	7
t3_jznpy5	Trump set on veto of defense bill over renaming bases honoring Confederates	u
t3_jyirvl	Do they just not care?' Miami immigrants troubled by surge of Latino support for Trump	7
t3_k01k3h	Conservative Columnist Warns Of Donald Trump's Chilling Legacy For The GOP	7
t3_jzfcif	Trump Is Running Out Of Time As Key States Set To Certify That Biden Won	1,3
t3_jzw5up	Trump administration withdraws from Open Skies	3
t3_jywxtu	Michigan GOP Congressman Tells Trump 'It's Over': 'The Voters Spoke'	1
t3_jyunps	Trump, laden with $400 million debts, plans to cash in on his post-presidency with a book deal, media appearances, and selling rally tickets, according to a report	u
t3_k0eyot	Joseph Nye: "Trump deserves credit for pushing back on China's abusive trade practices, but it would have been better if we worked with our allies to isolate China. Also, his trade deal has been costly for Americans without changing the trade imbalance or addressing technological issues."	4
t3_jyulqn	Trump Team Files for Fresh Recount in Georgia's Presidential Race	1
t3_jyqnjd	In pushing his claims to the limit, Trump has revealed the fragility of the voting system - and shaken it	1,7
t3_jzp967	General Motors Aligns With Biden, Pulls Out of Lawsuit Supporting Trump	7
t3_k0azls	Trump's Enablers Are Sabotaging the Georgia Senate Runoff Electionand Helping Democrats. There's a weird, right-wing push to boycott January's pivotal U.S. Senate runoffs. Is Trump angry enough to join it?	1
t3_k08icm	Could Social Alienation Among Some Trump Supporters Help Explain Why Polls Underestimated Trump Again?	u
t3_jzsfqc	First Latino tapped to head DHS signals shift from Trump's hard-line immigration policies	5
t3_k0egox	At Trump's final bizarre turkey pardon, his ongoing refusal to concede was the elephant in the room. The president talked up the Dow and made a racist swipe at the "China virus," but no mention of the transition	3,7
t3_k06dr2	No, It Wasn't a Coup Attempt. It Was Another Trump Money Scam.	7
t3_jyjecp	Wisconsin officials: Trump observers obstructing recount	1
t3_jzfqzc	Do Trump-Supporters Live in an Alternate Universe? Actually a huge number of Americans have a false impression of reality because they are being told lies by their media. The people who constantly hear these lies do live in an "alternate reality."	7
t3_jynp3x	Trump Orders Hasty Afghanistan, Iraq Drawdowns to Beat Biden Inauguration	3,5
t3_jzoam2	Reality Forecloses on the Trump Presidency | A fading campaign collapses under the weight of finally having to back up big talk with actual substance.	7,3
t3_jzijpr	Trump Pulls Out Of Military Transparency Treaty With Russia, Europe	5
t3_jygs96	Merkel's Germany Tells Trump Not to Bring Troops Home from Afghanistan	5
t3_jy0f6f	Donald Trump Jr tests positive for coronavirus	2
t3_k07khz	Kremlin and Putin will not recognise president-elect Biden despite Trump announcement	5,1
t3_jyb540	Where and why President Trump's election challenges are falling flat in court: explainer	1,7
t3_jyamtf	Barack Obama: 'Donald Trump and I tell very different stories about America'	u
t3_jz7p9d	In Apparent Glitch, Voting Machines Hunt Down And Murder Trump Supporters	1
t3_jzmvi7	Trump's on his way out, but leaves a lasting legacy: The right's open embrace of terrorism. How did the Kenosha shooter post $2 million in bail? Because conservatives are normalizing right-wing terrorism	7
t3_jztxao	What Donald Trump Liked About Being President	u
t3_jzb3ya	Trump campaign cuts ties with attorney Sidney Powell after bizarre election fraud claims | US news	1
t3_jztmee	Trump Responsible For Largest Rescue of American Hostages	u
t3_jzrwc2	Pennsylvania Supreme Court Kills Trump Bid to Disqualify Ballots	1
t3_jzjgop	Open Letter Calls on Harvard to Create 'System of Accountability' for Inviting Trump Admin Alums to Campus	7
t3_jxvhyz	Lin Wood: President Trump won 400 electoral votes | One America News Network	1
t3_jyzr2m	A Republican judge just tore into Trump's election lawyers for their incompetence. Trump's lawyers asked a judge to disenfranchise nearly 7 million voters. It ended badly for Trump.	1,7
t3_k028sg	Sen. Chris Murphy: Why Biden needs to see Trump's vaccine plan right now	3,2
t3_jzskav	Pennsylvania Supreme Court Reverses One of Trump's Only Post-Election Litigation Wins	1
t3_jyy2z6	Bolton calls on GOP leadership to label Trump's behavior 'inexcusable'+D80	7
t3_k05ja4	Since Election Day, a Lot of Tweeting and Not Much Else for Trump	7
t3_jy6uie	A destructive legacy: Trump bids for final hack at environmental protections	6,7
t3_jyzpvt	How Trump Responded When Liz Cheney Called on Him to Concede: "Sorry Liz, can't accept the results of an election with hundreds of thousands of fraudulent votes cast, enough to easily flip the Election. You're just unhappy that I'm bringing the troops back home where they belong!"	1
t3_jzk7yg	A Federal Judge Rejected Trump's Ludicrous Pennsylvania Case With Pure Disdain	1,7
t3_jx9ucr	Trump Campaign Says It Has Uncovered Enough 'Fraud' To Overturn Election Result	1
t3_jyx06u	Election Updates: Trump Campaign Faces Major Legal Setbacks; Biden Wins Certified	1
t3_jyjte3	Ilhan Omar Urges Biden to 'Reverse' President Trump's Middle East Agreements -- Thinks that peace between Israel and Arab nations is a bad thing.	5
t3_jz6p3p	Stop Golfing And Concede' | Gov. Larry Hogan Hits Back At President Trump's Tweet On South Korea COVID-19 Tests	2,7,3
t3_jzw2s8	Trump Tells GSA, and His Team, to Begin the Transition Process; Vows to 'Keep Up the Good Fight'	3
t3_jy2xn6	Plaintiffs in Trump's lawsuits embrace conspiracy theories one has even violated election laws. One of the plaintiffs was once accused of election fraud and fined for multiple violations of campaign laws	1,7
t3_jzl729	Trump Team Disavows Lawyer Who Peddled Conspiracy Theories on Voting	1
t3_jy5c91	Trump Got Tricked by a Twitter Troll Posing as His Sister	u
t3_k05kkv	Every Day Trump Repeatedly Emails His Supporters a Dangerous Message: Democracy Doesn't Work. Be outraged, don't accept the election results and send money.	7,1
t3_jyhdoi	Trump tweets undermine Michigan leaders; images show Chatfield drinking at Trump hotel	7
t3_jzr6vb	Michigan's Board Of Canvassers Certified Biden's Win In A Big Loss For Trump's Desperate Bid To Overturn The Election	1
t3_jz3ygy	Refusing to concede, Trump pushes for another recount in Georgia	1
t3_jxnnin	Trump's extrajudicial attempt to 'stay in office' would have 'terrified most of the founders,' historian says	7
t3_jz3iys	Small but growing number of Republicans tell Trump it's over: "Stop golfing and concede"	3,7
t3_jz0mm7	Bolton: 'Trump is throwing rocks through windows'	7
t3_jyktn9	Trump playing Golf instead of cooperating to fight the Coronavirus Pandemic	7,2
t3_jy17l6	Kayleigh McEnany Obliterates Both Dems, Media for Hypocrisy Over Election Results, Completely Levels CNN Reporter: "Where were the calls for unity and a peaceful transition when President Trump was elected in 2016?"	3
t3_jye8sy	Latinas for Trump founder unseated Florida Democrat after seeing 'shadow candidate' enter race	u
t3_jyvv5t	Trump team requests another recount of Georgia's presidential race, a day after results certified in Joe Biden's victory	1
t3_jzud9p	Bernstein names 21 Republican senators who privately expressed contempt for Trump	7
t3_jzh7ew	Carl Bernstein names 21 Republican senators who have 'privately' expressed 'extreme contempt' for Trump	7
t3_jyzfzs	Chris Christie Says Trump's Legal Team Has Become a 'National Embarrassment'	7
t3_jyl201	A vindictive Trump seeks to undermine Biden's presidency	7
t3_k06pds	Fox News' Laura Ingraham and Tucker Carlson distance themselves from Trump	7
t3_jyno88	Pa. Senator Pat Toomey Says President Trump Has 'Exhausted All Plausible Legal Options'	1
t3_jy58b1	Senators who urged 'voters to decide' impeachment won't admit Trump lost the election	1
t3_jyh09y	Opinion | Who Will We Be Without Donald Trump?	u
t3_jylbj0	CNN Condemns Trump Rallies As 'Physically Peaceful But Morally Violent'	7
t3_jyhutc	Obama jokes that Navy SEALs could remove Trump from the White House	u,7
t3_jz1pj8	Mao's Lesson for Trump's America | Beware of leaders willing to set their own country on fire.	7
t3_jzvyov	Perdue, Loeffler Join Trump Call for New Georgia Recount	1
t3_jzntsc	GOP Former National Security Officials Urge Party to Demand Trump Concession	3
t3_jze8d0	Transition warning: Trump's mental illness is a growing danger	3,7
t3_jyz588	Chris Christie: Trump's legal team has been 'a national embarrassment'	7
t3_jz1z65	Stop golfing and concede': Trump and Maryland Gov. Hogan spar again after president criticizes South Korean tests	3,5
t3_jylq42	Trump Orders Hasty Afghanistan, Iraq Drawdowns to Beat Biden Inauguration	5
t3_jzvf9k	Dr. Redlener: Trump's denial of science has 'poisoned' this country	7,6
t3_jyvqgz	Guilfoyle: You Can't Stop Rudy, You Can't Stop Trump	7
t3_jy4hqf	Facing an Election Loss, President Donald Trump Turns to Raw Political Power to Try to Bend the Outcome	1,7
t3_jzk5a1	A Circuit Breaker on Election Night? (...nearly 30 percent of Democrat voters think the election was stolen from Trump)	1
t3_jzscgu	GM Abandons Trump Admin in Lawsuit Over California Emission Standards, a Sign Automaker Knows Biden Will Be Taking Over	6,3
t3_jx86xn	Romney: Surprising People Believe Trump's Fraud Claims	1,7
t3_k081u3	Kash Patel, recently installed Trump loyalist, now leading Pentagon transition	7
t3_jzieod	GOP Can't Let Trump-Hating Squishes Take Over the Party Now	u
t3_jyzuxq	Chris Christie: Trump's Legal Team Has Been a 'National Embarrassment'	7
t3_jycgfg	Shame the Random, Unknown Government Officials Aiding Trump's Coup Attempt	7
t3_jzmm3y	Biden signals sharp pivot from Trump's unconventional foreign policy with pick of insider Antony Blinken	5
t3_jzjbne	Sidney Powell Confirms Non-Affiliation With Trump Legal Team, Vows to Continue Fraud Fight	1,7
t3_jzpdpe	Trump's election lawsuit leads to 3rd Circuit grant for expedited review	1
t3_jzonsl	Former Defense Secretary Jim Mattis says Biden should toss all of Trump's 'America First' policies	u
t3_jyqcfr	After Pennsylvania court defeat, Trump faces new pressure to concede election	3,1
t3_jyvpw5	BREAKING: FDA Grants Emergency Use Authorization To Antibody Cocktail Used By Trump	2
t3_jyztx6	Do Trump Supporters Live in an Alternate Universe?	7
t3_jyle31	'Certify the Results!': GOP Michigan Lawmakers Blasted for 'Legitimizing a Fascist Coup Attempt' by Meeting With Trump	1,7
t3_jyys5f	Republican Gov. Larry Hogan is 'embarrassed that more people in the party aren't speaking up' against Trump's refusal to concede	3,7
t3_jzhelc	Mike Flynn Jr. adds twist to Trump team's statement on Sidney Powell: 'Give this the 24hr rule  '	u
t3_jxxr0v	Georgia certifies election results confirming that Biden beat Trump	1
t3_jyjz6o	Trump privately plots his next act - including a potential 2024 rematch	u
t3_jzfuso	Trump team falsely claim he was not assisted in transition by Obama	7,3
t3_k083ym	Pennsylvania Certifies Biden as Winner, Driving Stake in Trump's Legal Effort	1
t3_jz7fr3	Latest: Why a Federal Judge Tossed Out One of the Trump Campaign's PA Lawsuits	1
t3_jzsjjw	Over 100 CEOs threaten to cut off funds to Georgia GOP if Trump keeps blocking transition: report	1
t3_jyuhux	Trump campaign attorney responds to Pennsylvania ruling &amp; they're grateful	1
t3_jzny0i	Pennsylvania Republicans Voted Against Certifying Vote in County Trump Won by 22,000	1
t3_jy9clr	Trump wanted to bomb Iran and still could leaving Biden to pick up the pieces	5
t3_jzlnvy	A major Trump donor's company got a 3 percent government-backed pandemic loan. It sells title loans at a 350 percent annual rate.	7,2
t3_k02n7d	Should Trump Be Prosecuted?	7
t3_jykt0d	Michigan AG Suggests Criminally Charging Republican Legislators for Meeting With Trump	7
t3_jy2a6s	Trump bid to overturn vote crashes into wall of deadlines | On the heels of Georgia's official recognition of Joe Biden's victory, a gauntlet of other certifications in the coming days could deal a crushing blow to the president.	1
t3_k025lg	Arizona Republican compares Trump election dispute with Japanese soldiers fighting after WW2 ended	7,1
t3_jzq2dw	Poll: Majority say Trump should concede	7,3
t3_jysta7	Trump camp's lawsuit struck down in Pennsylvania	1
t3_jzrwf7	Indiana senators Braun and Young deny report they privately hold Trump in contempt	u
t3_jzi8g6	Trump's legal team's statement on Sydney Powell was made to focus on the upcoming Supreme Court case. There are two separate legal pathways. One on equal protection and PA voting rules (most important right now). The second is Dominion software which will take longer.	1
t3_jyp3bc	Trump campaign files for new recount in Georgia	1
t3_k0dyrm	The Republican Party Is Dead. It's the Trump Cult Now.	7
t3_k03gjd	Biden unveils his administration as Trump's firewall crumbles	3
t3_jyaacw	Kayleigh McEnany's Latest Trump Lie Is Firmly Debunked In Viral Video	7
t3_jyfij4	Georgia Gov. Kemp Calls for Audit, Says Trump Can Demand New Recount	1
t3_jz4ivr	Nearly all Pa. counties expect to sign off on election results by Monday despite Trump's attempts to delay certification	1
t3_jzwgzq	Rush Limbaugh, Michigan, GSA hammer nails into coffin of Trump's election fraud claims	1
t3_jzhcb0	What if Trump never concedes? The Constitution will end his term, conservative lawyer John Yoo says	3
t3_k07u3h	Trump has set a hidden trap for Biden. It could do great damage.	7
t3_jy4cdz	Michigan group sues Trump campaign citing disenfranchisement of Black voters - The plaintiffs say the campaign's legal challenges to the election violated their voting rights.	1,7
t3_k0826z	Trump's Pentagon Now Vetting Nonpolitical Experts	u
t3_jy0o3b	Michigan and Georgia Republicans Just Crushed Trump's Coup Dreams	1
t3_k06bmj	Trump Mocked After Telling GOP to Listen to Randy Quaid's Election Demand	1,7
t3_k03bun	Trump's awkward exit leaves behind a big problem	7
t3_jy3i78	Trump's election legal strategy is all but doomed, but still could damage American democracy, experts say	1,7
t3_jyo46m	Trump Seeks Expedited Appeal of Pennsylvania Ruling Against Effort to Toss Mail-In Ballots	1
t3_jzj73m	Trump's press secretary Kayleigh McEnany heckled in briefing: 'When will you admit you lost?'	3
t3_jy1p1c	Michigan lawmakers meet with Trump, say they haven't seen evidence of voter fraud	1
t3_jzsjet	Trump campaign says it will continue legal fight after Michigan certification	1
t3_jzrvao	Michigan votes to certify Biden's win over Trump	1
t3_jz6lhi	Threats to Election Officials Piled Up as President Trump Refused to Concede	1,3
t3_jy3mhv	Biden's margin of victory over Trump surpasses 6 million votes	3,1
t3_jz37gc	Trump Derangement Syndrome in Democrats won't go away with Trump	u
t3_jyp5q9	Actor Scott Baio threatens to move to Utah to unseat Sen. Mitt Romney after his anti-Trump tweet	u
t3_jz1vvt	Patrick Buchanan: "Is Trump Exiting Afghanistan -- to Attack Iran?"	5
t3_k04x2c	Cannabis stocks surge after Trump administration sets formal transition in motion	4,3
t3_jzth0n	Seven Letter Poll: 79 Percent of Trump Voters Say Election 'Stolen'	1
t3_jyz99e	Trump Lawyer Sidney Powell Promises 'Biblical' Lawsuit in Coming Days	u,1
t3_jyvrie	Trump's embarrassing, incompetent, humiliating, very sad coup	7
t3_jzaqqe	An statement from Senator Toomey regarding the Pennyslvania Federal Court decision regarding the Trump campaign lawsuit.	1
t3_jzorhc	Trump fears Giuliani, other lawyers in Biden vote challenge are 'fools that are making him look bad'	1
t3_jy56dt	Trump Announces New Regulations Lowering Prescription Drug Costs	4
t3_jyqowe	Michiganders Erupt After Their Maskless Lawmakers Sip Dom Perignon At Trump Hotel - Michigan legislators celebrate together after secretive meeting with Trump, who has been plotting to overturn the state's vote for Joe Biden.	1,7
t3_jyxl1z	How to explain Latino support for Trump? ABC News reports misleading memes went viral in Latino communities	u
t3_jyjoh2	Election 2020 updates: Michigan GOP Speaker Chatfield drinks at Trump Hotel; Carson was 'desperately ill' from COVID	2
t3_k06fcj	Trump To Pardon Turkey Again, Trying To Show Normalcy Amid The Abnormal	7
t3_jz5rv6	Trump campaign says Sidney Powell not a member of legal team	u
t3_jz3tl3	Michael J. Fox says Donald Trump has played on 'every worst instinct in mankind': 'Biff is president!'	7
t3_jzmj9c	Political Enemy List Trump Accountability Project Publicly Posted on Their Website	7
t3_jyb4tl	6 Big Claims by Trump's Lawyers About Overturning Election Results	1
t3_jyq2e5	Trump campaign requests recount in Georgia	1
t3_jyxajt	After Pennsylvania legal defeat, Trump digs in despite new pressure to concede election	1
t3_jydyix	The Major Difference Between Black Male and Female Voters Black male turnout for Trump wasn't indicative of the president's successful outreach efforts, but rather the long-standing relationship between this voting bloc and the GOP.	u
t3_k005l3	President Trump: "We are moving full speed ahead. Will never concede to fake ballots &amp; 'Dominion'"	1,3
t3_jyw52m	Biden faces politically thorny decision on Trump prosecutions | TheHill	3
t3_jy5hil	Who needs Russia? Loudest attacks on US vote are from Trump	7,1
t3_jxo81v	Obama says all Americans 'should be troubled' by Trump's efforts to subvert democracy. 'I'm less surprised by Donald Trump doing this, he has shown, you know, only a flimsy relationship with the truth,' says Obama	1,7
t3_jynt1e	Trump tells G20 leaders he wants to work with them 'for a long time'	5
t3_k0g3pq	GOP Congressman Suggests Trump Voters Mimic Post-WWII Japanese Soldiers Who 'Kept Fighting for Decades'	1,7
t3_jyoleb	Kayleigh McEnany said Trump wasn't given an 'orderly transition of power' in 2016. He was.	3
t3_jymfwh	Wisconsin election officials say Trump observers obstructing recount, some 'clearly don't know what they are doing'	1,7
t3_jzezl2	Opinion | Trump's Legal Farce Is Having Tragic Results	7,1
t3_jztbkw	As Fox News breaks up with Trump, new sweethearts emerge	7
t3_jycdqu	Why Can Trump Try To Steal The Election? Blame The Electoral College.	1,7
t3_jya79l	People Think Mnuchin Accidentally Said Trump Admin's Most Honest Thing About COVID-19	2
t3_jzv44u	Trump Supporter Charged with Simple Assault for Breathing on Protesters	7
t3_jypjqa	Merkel's Germany Tells Trump Not to Bring Troops Home from Afghanistan	5
t3_jzvrkx	Trump came in promising so much winning. He's going out with so much whining.	7
t3_jy1csd	Hispanic Voters in Florida Feel Election Was Stolen from Trump	1
t3_jx2ieq	New York Times op-ed admits 'Trump was right,' Democrats 'wrong,' about keeping schools open "Some things are true even though President Trump says them"	2
t3_jz44h2	Bernie Sanders says GOP 'has ceased to be a political party' and is now a 'cult' in fiery rebuke of Trump fraud claims	7,1
t3_jyv0um	FDA Grants Emergency Use Authorization To Antibody Cocktail Used By Trump	2
t3_jzo75x	GM hits reverse on Trump effort to bar California emissions rules	6
t3_jy0vje	Trump's daughter-in-law Lara reported to be considering 2022 Senate run	u
t3_jyyeac	Chris Christie Tears Into Trump's Legal Team: 'A National Embarrassment'	7
t3_jztjh2	National Embarrassment Donald Trump Worried Lawyers Are Sullying His Pristine Reputation	7
t3_jxocbx	[Not Satire] National Democratic Party official suggests re-education for Trump supporters: 'How do you deprogram 75 million people?'	7
t3_jxs85q	Exhibit Q': Lawyer Lin Wood Submits that Michigan Is Really Minnesota in Failed Pro-Trump Election Affidavit	u
t3_jz9dqx	Lou Dobbs Warns the GOP: Republican Party 'Will Be Gone and Done' If They Don't Stand With President Trump	u
t3_jzsruy	Rush Limbaugh Does Full 180, Blasts Sidney Powell After Team Trump Disavowed Her	u
t3_jxsqbc	Do Trump's Lawyers Know What They Are Doing?	7,1
t3_jzqg3e	Trump campaign suffers new court loss in attempt to block Biden's win in Pennsylvania	1
t3_jzj6tl	Trump's election fight includes over 30 lawsuits. It's not going well.	1,7
t3_jy248u	Anti-Trump Legal Team Withdraws In Pennsylvania	1
t3_k0esea	The Trump administration is considering shortening the recommended quarantine time for Covid-19	2
t3_jzg8x4	'Elite Strike Force'? Trump Legal Team Throws Right-Wing Attorney Sidney Powell Under the Bus as Coup Attempt Flails	7
t3_jywjti	40% of Top Pentagon Positions Empty After Donald Trump's Firing of Mark Esper	u
t3_jxyiu8	The Growing Backlash Against Trump's Efforts To Subvert The Election	1,7
t3_jw2kpj	BREAKING: Second Georgia County Finds Thousands More Votes, Majority Are For Trump	1
t3_k00s3i	Vt. AFL-CIO OKs strike if Trump refuses peaceful transfer of power	3
t3_jzdaid	Report: Maryland Gov. Larry Hogan, Anti-Trump Hero, Paid for Flawed Coronavirus Tests from South Korea	2,5
t3_jxpo6l	GA secretary of state: I'm a proud Trump supporter but numbers don't lie	1
t3_jz4v45	Longtime diplomat says Trump conspiracies hurt U.S. more than Russia, China	7,5
t3_jz227v	GOP Senator Has Instructed Staff to Cooperate With Biden Transition, Says It's 'Past Time' for Trump to Do Same	3
t3_jxny9j	Trump Legal Adviser Jenna Ellis Rips Media: 'You Are Not Unbiased Jurors'	u
t3_k0c5mr	Paul Ryan calls for Trump to accept results: 'The election is over'	1,3
t3_jzu5h2	The Socio-Political Legacy 0f Trump	u
t3_jz8ywc	Trump campaign legal team distances itself from Powell	u
t3_k0a761	Trump brags about Dow 30,000 at surprise press conference, leaves after a minute	4
t3_jzvqda	Trump Lawyer Appears on Fox Touting 'Promising' Case in Pennsylvania After It's Thrown Out by Judge	1,7
t3_jzqzld	Trump campaign forces Georgia taxpayers to pay for second recount after first one confirms its loss. A hand recount of nearly 5 million votes confirmed Biden's win, but Team Trump wants to milk taxpayers even more	1,7
t3_jzr85t	Michigan election board votes to certify Biden win, dealing blow to Trump effort	1
t3_jylfat	Hispanic Voters In Florida Who Fled Dictatorships Think The Election Was Stolen From Trump	1
t3_jyaidt	The Danger (and Ineptitude) of Trump's Failed Coup	7
t3_jz3bhq	Pennsylvania election: Trump appeals dismissal of bid to block vote certification	1
t3_jzozd1	Why the Trump campaign's big legal flameout in Pennsylvania seems like a turning point, even for Republicans	1,7
t3_jyza13	A Final Try by Trump to Cut Drug Prices May Stumble in Court	4
t3_k0ftlb	McConnell pushed Trump to nominate Coney Barrett on the night of Ginsburg's death: report	u
t3_jz5f71	Julie Burchill: President Trump has loved and been great for Israel	5
t3_jypu3s	Trump campaign, rebuffed by district judge, says taking Pennsylvania mail-in ballots case to Supreme Court	1
t3_jzg091	Biden is stealing the spotlight. Trump can't stand it.	7
t3_jxxtr7	Trump lawyers cited Minnesota counties in affidavit about Michigan: report	1
t3_jxyfjw	More conservatives break with Trump over election claims	1
t3_jyevov	Trump Supporters in Georgia Threaten to Destroy GOP, Boycott Runoff Elections	7
t3_jyaufj	Berkeley professor sparks outrage by claiming Trump supporters who have an 'indifference' to COVID are like Germans who 'ignored and profited from the Holocaust'	2
t3_jykt2t	Trump forges ahead with frantic effort to overturn election | Having exhausted many of his legal options, Trump is looking at other ways to subvert Joe Biden's victory.	1,7
t3_jy6jmy	Analysis: With Silence, GOP Enables Trump's Risky Endgame	7
t3_k00bnt	Trump's legacy may be an increasingly authoritarian Republican Party	7
t3_jzprxe	Trump's Absurd 'You Did It First' Argument for Stealing the Election	1,7
t3_jzta4e	Trump Administration To Start Transition Process For Biden	3
t3_jzmus9	Donald Trump's Bid to Steal the Election Hinges on a Shameless Homophobe Who Once Called Him a Lying, Idiotic Bully	1,7
t3_k0g74u	Trump Push To Invalidate Votes In Heavily Black Cities Alarms Civil Rights Groups	1,7
t3_jyvhg1	Biden hits Trump for refusing to concede, says 'national mask mandate' discussed with govs	3
t3_k0dwtt	75% of every donation to Trump's leadership PAC could actually be spent by the president himself on things like paying family members or financing a 2024 bid	7
t3_jzg7iv	Trump's Emotional State Is 'Quite Fragile' After Election Loss	7
t3_jzi67h	Timeline: Trump's revolving door of lawyers	u
t3_jy2rb5	Trump lifts travel ban on Chad	5
t3_jyn8ch	FDA authorizes Regeneron's Covid treatment, taken by Trump, for emergency use	2
t3_jz2ux2	#Resist was a success, in looking back at Trump's presidency	u
t3_jzdr2f	Voting machines manufacturer on Trump conspiracy theory: 'It's not physically possible'	1,7
t3_jyp3ti	Trump Lawyers: Pennsylvania Lawsuit Dismissal Moves Us Closer to Supreme Court	1
t3_k03po7	Trump Contrives His Stab-in-the-Back Myth | An obscene conspiracy theory from the past echoes loudly in the present.	7
t3_jz5bfz	Trump campaign says Sidney Powell isn't a member of its legal team	u
t3_jzej98	Pennsylvania's Lt. Gov. Trolls Trump, 'Dopey' GOP Lawsuits In Epic Tweetstorm	1
t3_jz0akg	Trump, GOP's ridiculous, flailing coup isn't a joke. It's a crime. There must be consequences | Will Bunch	7
t3_jykr5a	Wisconsin Officials: Trump Observers Obstructing Recount	1,7
t3_jzhmo3	Business Leaders, Citing Damage to Country, Urge Trump to Begin Transition	3
t3_jyxu4b	Biden advisor: 'He does not have any concern' about Trump lawsuits	3
t3_jyunuj	Trump campaign adviser Steve Cortes: Sudden Stop In Mail-In Vote Count 'Suspicious' -- Particularly since it was followed by a "deluge" of votes for Joe Biden in key battleground states.	1
t3_jyd2rr	Watch: Sidney Powell  Millions of DEAD People Voted! 7 Million Votes STOLEN From Trump!	1
t3_jy79iv	Trump's monumental sulk: president retreats from public eye as Covid ravages US | Two weeks after his defeat, Trump has gone from always present to effectively missing, behavior that many say is an unprecedented and dangerous	2,7
t3_jz0yry	GOP Governor On Trump's Election Tantrum: Beginning To Look Like A 'Banana Republic' - "Frankly, I'm embarrassed that more people in the party aren't speaking up," Maryland Gov. Larry Hogan said.	7
t3_jz0mhl	Trump's wildest claims are going nowhere in court. Thank legal ethics. Thank legal ethics. The president's lawyers can't make assertions without evidence in front of judges.	1,7
t3_jz6unm	Lisa Murkowski calls on Trump to end court fights	1
t3_jz9hi3	Trump campaign legal team distances itself from Powell	u
t3_jzqp20	Trump-Appointed Judges Find Conversion Therapy Bans Unconstitutional	7
t3_jxori2	Solar Companies Ask Biden To Reverse Trump's Biggest Blow To The Industry	4,6
t3_jyqoj0	Dr. Ben Carson: Trump Saved My Life After I Got COVID	2
t3_jxnh2b	Lawyer working on Trump Pennsylvania effort placed under official protection due to threats	1
t3_jyc5ef	Trump options narrow as Michigan backs Biden win	1
t3_jyz8b3	For U.S. election officials certifying results, Trump's refusal to concede has chilling consequences	1,7
t3_jyca1s	The Trump campaign's much-hyped affidavit features a big, glaring error	7
t3_jznz36	Did Trump Pardon a Turkey That 'Refused To Concede' an Election?	7
t3_jzj1yp	Major business leaders reportedly signed a letter urging Trump to concede, and warn that 'our democracy grows weaker' the longer the presidential transition is delayed	7
t3_jyauqo	Conspiracy theories are Trump 'weapons' in desperate bid to cling to power	7
t3_jzx12o	Here Come the Adults | Biden's Cabinet is shaping up to be everything that Trump's was not.	3,7
t3_jxyws8	Republican leaders swore an oath to defend the Constitution. That means telling Trump it's over.	3
t3_jzvpb2	Comment I found in a recent thread that I think that a lot of the doomer-skeptics need to read. Not necessarily saying that Trump will *totally* pull through with the evidence, but I think all you Reddit detectives should at least give him some reasonable benefit of the doubt.	1
t3_jz1z44	Top House conservative plots post-Trump GOP	u
t3_jyw4pb	Trump's legal team cried vote fraud, but courts found none	1,7
t3_jz3dde	Trump is in an unprecedented streak of silence	u
t3_jxva3c	Edward Norton Lays Out Trump's "Desperate Endgame" Using Metaphor of Failed Poker Hand "The core of it is that he knows he's in deep, multi-dimensional legal jeopardy and this defines his every action," says the actor.	1,7
t3_jzaoie	In last-ditch bid to stay in office, Trump deploys his favorite tactics to bully and intimidate	7
t3_jyhv9o	Trump was pictured on his Virginia golf course during a coronavirus meeting for G20 leaders	2,7
t3_k06cum	Turkeys, Corn and Cob, expected to be first in slew of final Trump pardons	u
t3_jxwnu3	Detroit asks judge to sanction Trump campaign for spreading 'disinformation'	1,7
t3_jymtbq	Megathread: Judge Dismisses Trump Lawsuit Seeking to Delay Certification in Pennsylvania	1
t3_jzms1q	Pro-Trump Attorney Lin Wood Urges Republicans Not To Vote In Georgia Senate Runoff -- Unless GOP candidates help overturn the presidential election results in the state.	1
t3_jzpd7w	JUST IN: Third Circuit Court of Appeals Grants Expedited Review For Team Trump's Appeal in Pennsylvania	1
t3_jxwqi6	'Call his bluff': Edward Norton lays out poker-style Trump analysis we never expected	u
t3_jzvdc2	An OAN Host Has Been Helping Rudy With Trump's Legal Efforts	1
t3_k0bpfr	Two more parting shots from Trump aimed squarely at disabled workers	7
t3_jyvt2z	Wisconsin officials: Trump observers obstructing recount | Election officials overseeing the recount of presidential votes in Wisconsin's largest county are accusing observers for President Donald Trump of unduly slowing the process	1,7
t3_jxhh2f	New York authorities investigating millions in tax write-offs from the Trump Organization	u
t3_jyby0o	Trump Announces Groundbreaking Rules to Lower Prescription Drug Prices	4
t3_jybvbl	Analysis: With silence, GOP enables Trump's risky endgame	7
t3_jyejvj	Lara Trump reportedly mulling 2022 Senate run in North Carolina	u
t3_jym9cn	Pennsylvania Judge Dismisses Trump Campaign's Challenge to Pennsylvania Election Law	1
t3_k0ala4	Trump Turns to Randy Quaid for Guidance in Overthrowing Democracy	7
t3_jy8elg	Most Republicans greet Trump's push to overturn the election with a customary response: Silence	1,7
t3_jz1up7	Trump Lawyer Says New Lawsuits Will Be Filed in Georgia Soon: 'Quite a Shock'	1
t3_k0gvyf	A Trump Appointee Is Trying to Force New Bank Investments in Fossil Fuel Extraction	4,6
t3_jzla7n	Michigan voters sue Trump for allegedly disenfranchising Black voters with election interference	1,7
t3_jz60sj	Dominion responds to Trump team claims	u
t3_jyqipn	Time is just not on Trump's side to overturn 2020 election results	1
t3_jzvs4f	Trump Tells GSA, and His Team, to Begin the Transition Process; Vows to 'Keep Up the Good Fight'	3
t3_k0flki	Mueller Probe's Andrew Weissmann Wants Biden DOJ to Prosecute Trump	u
t3_jz0az8	Pennsylvania GOP Sen. Toomey Says Trump Should Accept Election Loss	3
t3_jz557f	Pat Toomey: Trump Campaign Has Exhausted Legal Options and Biden Won	3
t3_jxtupb	'Call His Bluff': Edward Norton's Viral Message On Trump	7
t3_jzloh0	Watergate journalist Carl Bernstein outs 21 Republican senators who 'privately' expressed 'extreme contempt' for Trump.	7
t3_jxqskc	Michigan Republican leader is meeting with Trump at White House to discuss coup	u
t3_k05u50	Glum Laura Ingraham Tells Fox Viewers It's Done: 'I'd Be Lying' If I Said Trump Still Had A Chance	u
t3_jz265e	Trump's legal team cried vote fraud, but courts found none	1,7
t3_jzseje	National Security Experts Urge Republicans To Demand Trump Concede The Election	3
t3_jza1rz	Trump campaign cuts ties with attorney Sidney Powell after bizarre election fraud claims	1
t3_jxnr50	Lara Trump mulling 2022 Senate run in North Carolina: report	u
t3_jyx846	Sen. Toomey Congratulates Biden After Pennsylvania Judge Dismisses Trump Lawsuit	1
t3_jyx75d	House Democratic Caucus chairman: Trump's presidency was a 'scam'	7
t3_jzsh0c	Trump Lawyer: Michigan Legislature Agrees to Hold Election Review Hearings	1
t3_jyg473	Battered by setbacks in push to reverse Biden win, Trump persists with fraud claims	1
t3_jz67og	Trump Yet to Answer One Press Question Since Election As GOP Pressure for His Concession to Biden Grows	3
t3_k08hk3	America survived Trump's coup attempt. The media needs to be clear about why.	7
t3_jzkuz6	Trump Faces Growing Calls From Biz Leaders To Concede After Legal Battles Fall Flat	3
t3_jzjoc9	Republican former national security officials urge party to demand Trump concession	3
t3_jzd94c	Carl Bernstein Names Names: 21 GOP Senators Who've Privately Ripped Trump	7
t3_k0du5r	Ivanka criticised for boasting about greenhouse gas emissions drop under Trump administration	6
t3_jn3u8p	Trump dancing after 5th rally on Sunday	u
t3_jyl1vt	Michigan GOP legislators appear at Trump Hotel after White House meeting	u
t3_jqdmpe	Romney says Trump should 'follow every legal option he has,' but choose words 'carefully'	1
t3_jzjl2a	Republican national security experts call on Trump to concede, begin transition	3
t3_jyemqz	Donald Trump Will Lose One Of His Twitter Accounts To Joe Biden On Inauguration Day. An account the president uses to retweet his conspiracy theories and vitriol will be wiped and handed over to the Biden administration.	1,3
t3_k03iou	In Break From Trump, Biden Opts for Experience, Expertise for Top National Security Jobs	3,7
t3_k0g41t	YouTube suspends One America News, a Trump favorite, for peddling pandemic misinformation	u
t3_jz0c9x	Satire: CNN Condemns Trump Rallies As 'Physically Peaceful But Morally Violent'	7
t3_jxtm8p	Hoyer on Trump election challenges: 'I think this borders on treason'	1,7
t3_jzc0q0	Trump's lonely G-20 marks a fitting end	5
t3_jxovi4	Latinas for Trump founder unseated Florida Democrat after 'shadow candidate' with his surname entered the race	u
t3_jxtgbd	Trump's press secretary Kayleigh McEnany heckled in briefing: 'When will you admit you lost?'	3
t3_jzu0rh	Rush Limbaugh On Trump's Legal Team: 'They Promised Blockbuster Stuff And Then Nothing Happened'	1,7
t3_jz61e3	Former Ohio Gov. John Kasich Says GOP Is 'Afraid' Of Trump	u
t3_jz45sv	More key Republicans tell Trump to end delays. 'Past time to start a transition'	3
t3_k028s9	Roger Stone-Tied Group Threatens GOP: If Trump Goes Down, So Does Your Senate Majority	u
t3_jyzf5a	Hogan: Trump making US look like a 'banana republic'	7
t3_jxuonz	Elected DNC Member Floats Re-Education Camps for Trump Supporters	7
t3_jycumy	How Members of Anti-Immigrant Extremist Groups Have Worked Closely with and Joined the Trump Administration	5,7
t3_jyd46w	Trump has longstanding history of calling elections 'rigged' if he doesn't like the results	1,7
t3_jxxp5g	A Trump official is still blocking Biden's presidential transition. House Democrats want answers.	3
t3_jzka2y	Pro-Trump Attorney Urges Republicans Not to Vote in Georgia Runoff	u
t3_jy1cr9	Gregg Jarrett Has an Important Reminder for the Media About the Trump Campaign's Evidence of Voter Fraud	1
t3_jzvx08	NYPD planning to reduce police presence, congestion around Trump Tower: Sources tell ABC News	u
t3_jz1nzm	National Review Slams Trump's Refusal To Concede As 'A Bid For Infamy' The conservative magazine condemned the baseless lawsuits and conspiracies of the Trump legal team as a  profoundly undemocratic gambit. 	7,3
t3_jyk8mk	My Frustration Turned Into Anger.' Some Americans Who Lost Family Members to COVID-19 Have Turned Against Donald Trump	2,7
t3_jzt9rt	Fearing turmoil, Wall Street ups pressure on Trump to quit	7
t3_jyd786	Trump supporters plan D.C. rally two days before electoral college votes are cast	1
t3_jziwyr	What if Trump won't leave the White House? A hostage negotiator, an animal-control officer, and a toddler whisperer have advice	7,3
t3_jzvflg	Pennsylvania counties certify election results despite isolated pushback and baseless fraud claims from Trump allies	1,7
t3_jzmemb	Trump Lawyer Tries To Toss Out His Own Vote In Wisconsin Recount	1,7
t3_jxqlnp	Mitt Romney on Trump: 'It is difficult to imagine a worse, more undemocratic action by a sitting American President'	7
t3_k03h7b	Trump Push To Invalidate Votes In Heavily Black Cities Alarms Civil Rights Groups	1,7
t3_k0gb84	Democrats Compare Trump's Legal Team to Monty Python Sketch in Response to Pennsylvania Appeal	1
t3_jyp7pw	Judge Dismisses Trump Campaign's Pennsylvania Lawsuit, Slams 'Strained' Reasoning; This only helps these cases reach higher levels of court because signed affidavits are admissible in court	1,7
t3_k08slh	On Night of Ginsburg's Death, McConnell Pushed Trump to Nominate Amy Coney Barrett	u
t3_jy0cbd	Opinion | Georgia Certifies: Donald Trump Lost	u
t3_jznypc	Trump campaign takes Pennsylvania election fight to federal appeals court	1
t3_k08ewo	Brennan takes final shot at Trump: 'I leave his fate to our judicial system, his infamy to history, &amp; his legacy to a trash heap'	7
t3_jzszg1	Michigan certifies Biden victory as Trump's legal team suffers further losses	1
t3_jzuuec	Biden team wants to understand Trump effort to 'hollow out government agencies'	7
t3_jyj6sy	AP Fact Check: Trump's flailing effort resting on mendacity	7
t3_jzba0d	Carl Bernstein names 21 GOP senators who 'privately expressed their disdain' for Trump	7
t3_jywgwe	Republican senator congratulates Biden telling Trump to 'accept outcome of election'	3
t3_jyat09	Michigan group sues Trump campaign for alleged mass voter suppression	1,7
t3_k0hayq	Conservative insiders say Republicans aren't scared of Trump now they're scared of his supporters	7
t3_jyfwel	Analysis: How Georgia proves Trump has no chance of winning	1
t3_jxsv1q	Trump Campaign Fact-Checks the Media: Georgia Has Not Certified Biden's Win	1
t3_jyxn3r	Hogan 'embarrassed that more people' in the GOP 'aren't speaking up' against Trump	7
t3_k02t1v	Poll: Majority of Republicans would support Trump in 2024	u
t3_jzm3h2	GTFOH Trump Watch: Trump Released the Kraken. Turns Out the Kraken Was Sidney Powell	7
t3_jyrsd4	America is being subjected to a stress test  and Republicans are failing | Most elected Republicans are refusing to stand up to Trump. Their cowardice is one of the worst betrayals of public trust in the history of our republic	7
t3_jyll6a	Trump's State Department to defund international non-profits that support BDS	5
t3_jyga4y	Judge rules against Trump global media chief after firings	u
t3_jxyvco	Trump administration revives talk of action on birthright citizenship	3
t3_k05ep2	Surgeon General Issues 'Dire' COVID-19 Warning As Trump White House Plans Indoor Parties	2
t3_k0e2uk	Donald Trump's Destruction Of Documents	7
t3_jyfn88	Trump tweets about election results and skips session on pandemic during G20	7,2
t3_jz4z41	No, You Do Not Have to Feel the Trump Voter's Pain | There is no reason, after five and half years of untruths, dog-whistles, slurs and conspiracies, and weeks of Trump trying to undermine Biden's win, to hug the people who want to disenfranchise you	7
t3_jy0r0u	Obamas producing Netflix anti-Trump comedy show	u
t3_jxp6a0	An attorney leading Trump's attempt to subvert the election results is a longtime QAnon supporter	1
t3_jy5qo8	Biden's margin of victory widens as Trump's subversion efforts grow more frantic	1
t3_jxz5ec	How the GOP Is Helping Trump's War on Democracy. They are giving the president  space to poison the national debate and to try to overturn an election.	1,7
t3_jzbqm7	Trump campaign demands recount, signature matching in Georgia	1
t3_jzm3a5	Trump nearing last stand as efforts to challenge election slip	1
t3_jz5d4v	A Few More Hill GOPers Push Trump To Accept Reality As More Legal Battles Fall Flat	3,1
t3_k0bb2x	Trump's QAnon Lawyer Inspired Even More George Soros Disinformation	7
t3_jzjq3y	Michigan GOP Threatens to Delay Election Certification as Trump Continues to Challenge Results	1
t3_jzjzln	A Neighbor You Like Probably Voted For Trump	u
t3_jzq0dh	Biden's Europe challenge: Repair tattered transatlantic ties | Four years of Donald Trump have done serious damage to mutual trust.	5,7
t3_jzu5pb	The Authors of the Dictator's Handbook on What Trump Is Doing Wrong	7
t3_jz56nz	GOP senator says Trump to Biden transition should begin 'tomorrow morning'	3
t3_k02wgo	Maxine Waters Pushes for Investigation of 'Criminal' Trump To 'Send a Message Across the World'	7
t3_jyhl23	Week offers snapshot of how Trump, Biden approach presidency	u
t3_jzr751	Michigan board votes to certify the state's election results, dealing Trump another blow	1
t3_jzyoyz	Laura Ingraham Admits It's Over for Trump: 'Biden Will Be Inaugurated'	3
t3_jzcq86	As Biden marches forward with Cabinet, Trump hopes likely to fade in key states	3
t3_jy0m21	Donald Trump returns to the White House briefing room claiming he 'won' and suggests Pfizer held back vaccine to sabotage his election and says without him the drug would have taken four YEARS	2
t3_jy8vfz	Fareed Zakaria: Trump presidency is stomping on the face of democracy forever	7
t3_k089yi	'Malevolent travelers' coming if Trump's travel ban killed -- Biden has promised to eliminate executive order on 'Day 1'	3
t3_jzuphz	Trump goes out with a whimper and a tweet. It was always going to be that way	7
t3_jzw3ni	75 Percent Of Lawyers Say They Wouldn't Support Their Firm If They Represented Donald Trump Lawyers do *not* approve of what Jones Day's doing.	7
t3_jy4x55	Harvard Students Demand That Trump Officials Be Preemptively Barred From Campus	7
t3_jzrmfo	Who is Sidney Powell, the lawyer the Trump campaign is now distancing itself from?	u
t3_jz65om	Barack Obama on a Biden presidency, racism in the Trump era and what he misses about being president	7
t3_jya174	Judge slaps down Trump appointee who has sought to reshape Voice of America and related agencies	7
t3_k0f9nk	Where are the Republican Politicians? Have they Deserted Trump?	u
t3_jzo4ys	To Prevent 'Active Sabotage' of His Agenda, Biden Urged to Clean House of Trump Loyalists on Day One	7,3
t3_jyzag6	Chris Christie Calls Trump Legal Team 'National Embarrassment,' Tells President to End Election Suits	7
t3_jzu8wb	Trump accepts transition to Biden can begin	3
t3_k024k0	Biden says the Trump White House won't give him COVID stockpile information. Here it is.	2
t3_jztvos	Megathread: The GSA Has Informed President-Elect Joe Biden that the Administration is Ready to Begin the Formal Transition Process	3
t3_jzpbaz	General Motors Reverses Course, Spurns Trump-Backed California Emissions Lawsuit	6
t3_jye7eu	In 'Tremendous Rebuke' of Trump Appointee, Federal Judge Bars US Media Agency Head From Interfering in News Coverage | "Michael Pack has repeatedly and intentionally violated the First Amendment rights of VOA journalists."	7
t3_jzp4fh	Is Trump Selling Tickets to His 2021 Inauguration?	u
t3_jygefw	Who needs Russia? Loudest attacks on US vote are from Trump	7,1
t3_k06l7z	Yes, the Biden administration should hold Trump accountable	3
t3_k07qob	Patrick Buchanan: "What Trump Will Leave in Biden's Inbox"	5
t3_jzrpbc	Trump campaign to ask appeals court to halt Biden win in Pennsylvania	1
t3_jzpy16	On Trump, GOP's silence 'can't be excused and won't be forgiven' For the first time, a corrupt US leader is trying to cling to power through autocratic means. Let history note who lacked the patriotism to speak up.	7
t3_jy2k5b	Michigan attorney general ponders criminal probes of state and local officials who bend to Trump's will on overturning election results	1,7
t3_jysd13	Ben Carson Confirms Trump's Friends Get Better Coronavirus Treatments	2
t3_jz2555	In last-gasp maneuver, Trump campaign tries to invalidate thousands of votes as Wisconsin recount gets underway	1
t3_jzx73a	Trump's effort to steal the election is done	1,7
t3_jywz3f	How Trump Hopes to Use Party Machinery to Retain Control of the G.O.P.	u
t3_jzua12	GSA notifies Joe Biden that Trump administration is ready to start transition process	3
t3_jyefvb	Donald Trump says 'I won, by the way' and lashes out at Pfizer claiming it delayed news of the COVID-19 vaccine until after the election	2
t3_jz2hjq	Trump team making false argument about his 2016 transition	7,3
t3_jy2j68	Arizona's largest county certifies Biden win over Trump	1
t3_jymov0	Trump Warns 'Massive Fraud' to Be Uncovered in Michigan Vote	1
t3_jz614o	Trump legal team disavows association with lawyer Sidney Powell	u
t3_jzn4mo	Despite Trump's prod, Mich. to consider certifying Biden win	3
t3_jyqh97	Chinese Warn Against Communism at Trump Rally, Tell Americans to Speak Out	u
t3_jzqk4b	Secret Service members asked about protecting soon-to-be-former president Trump full time in Florida: Sources | Agents in Trump's detail have been asked about relocating to West Palm Beach.	u
t3_jzzo0f	Trump is worried Giuliani and legal team are 'fools making him look bad'	u
t3_jyw2mu	Trump threatens to wreak havoc on the GOP from beyond the White House	7
t3_jzmfmo	President Trump Wanted a Supreme Court Election Battle. His Current Appeal Simply Cannot Get Him There.	1
t3_jzq2wb	Sidney Powell responds to Trump Campaign legal statement with agreement but an  epic lawsuit is still coming this week	1
t3_jyhkqu	Judge rules against Trump global media chief after firings	u
t3_jz44bn	The Two Biggest Losers: Trump and Giuliani The bigoted New York septuagenarians team up for one last hurrah.	7
t3_jz72fx	Murkowski calls on Trump to begin transition process, decries 'pressure campaign on state legislators'	3
t3_k08cy8	Trump campaign continues to fight as more evidence of voter fraud emerges	1
t3_jz8td4	Here are the 3 legal cases Trump may have to face once he's no longer president	u
t3_jz7frn	Trump Campaign Formally Requests a Recount in Georgia	1
t3_k0cdoc	Trump ignores reporter's question about trying to pardon himself after doing so for turkey	u
t3_jziy4m	Two-thirds of GOP voters support Trump running for president in 2024: survey	u
t3_jziqei	Team Trump Fired QAnon Lawyer Sidney Powell But She's Tweeting Through It - Last week she was part of Trump's "elite strike force." Now she's "practicing law on her own."	u
t3_jy7n7y	Conservative News Site Warns Trump: 'Concede And Move On'	3
t3_jy9z3h	Trump tries to leverage power of office to subvert Biden win	3
t3_jy18x9	'We Will Follow The Law': Michigan Lawmakers Defend Election After Trump Meeting	1
t3_jyxjcj	Can America Restore the Rule of Law Without Prosecuting Trump?	7
t3_jxr80l	Michigan Senate Leader Shirkey swarmed by activists at airport before flying to meet with Trump	u
t3_k000zm	Trump strips Biden's options to boost the economy The most direct way the Fed could increase its aid to the economy is through two temporary lending programs.	4,7
t3_jxw71i	Trump's Stupid Coup, Which Hasn't Failed Yet, Is Distracting Us From What Needs to Be Done	7
t3_jzbe4j	Orwell's 1984 is prophetic: How the leftists are trying to change and erase President Trump and history	u
t3_jznqim	Explainer: Despite Trump claims, voter fraud is extremely rare. Here is how U.S. states keep it that way	1
t3_jy2fn8	President-elect Joe Biden Asks Public to Fund Transition as Trump Refuses to Concede	3
t3_jyvp5p	Federal judge rejects Trump campaign's Pa. lawsuit with prejudice, saying it lacks factual proof	1
t3_jzlu2s	All Republicans should support President Trump's legal fights -- Any who believe that buddying up to the Biden team is a symbol of unity, and better for America, have already abandoned Trump, conservatism, and America.	1
t3_jyix42	Trump does not participate in G-20 event on global pandemic preparedness	2,5
t3_jz5qcv	Brian Stelter Slams Lara Trump For Declaring Trump Voters Don't 'Feel' That He Lost -  Facts do not care about your feelings, the CNN host said.	7
t3_k08031	Trump: I'll Keep Charging Fraud Until Randy Quaid Is Satisfied	1
t3_jyxpbd	Trump Campaign Lawyers Step Up but Are Swiftly Knocked Down	1
t3_jz2ofa	Miami Republicans won't criticize baseless Trump claims of Venezuelan election rigging	1
t3_jyjnr1	Trump Campaign Lawyers File New Pennsylvania Motion Which Misspells Governor's Name	1
t3_jyih12	Yes, Trump Is (Still) Engaged in an Attempted Coup; and Yes, It Might Lead to a Constitutional Crisis and a Breaking Point	7,1
t3_jzlbdp	Trump friend and adviser Steve Schwarzman recognizes Biden as President-elect	3
t3_jzqz78	Trump will go, but Trumpism will remain	u
t3_k0ccin	Trump Takes A Break From His Bunker To Celebrate 'Sacred' Stock Market Gains	4
t3_jzjlmh	Democrat House Losses Stemmed From Trump Increasing Voter Turnout: Rep. Richmond	u
t3_jzt6dy	Appeals court to review Trump's Pennsylvania case -- Legal team on track with plan to reach Supreme Court	1
t3_jzr4r9	Georgia sets timeline for Trump-requested recount	1
t3_jzsqbv	Secret Service members asked about protecting soon-to-be-former president Trump full time in Florida	u
t3_jyxlr4	Analysis: Donald Trump has left the world stage. Few will miss him	7
t3_jytpjk	Pa. Senator Pat Toomey Says President Trump Has 'Exhausted All Plausible Legal Options'	1
t3_jyht3y	Pompeo's Grotesque Farewell Party in Israel Shows That the Trump Team Knows It's Over Pompeo used his visit to Israel and the settlements to push forward his pet ideological project and advance his post-Trump political career.	5
t3_jzmtno	Tucker Carlson was attacked by Trump supporters for questioning the outlandish claims of the president's lawyer Sidney Powell before she was fired	u
t3_k055sr	Republicans sold out democracy to appease Trump's loser tantrum	7,1
t3_jyobrs	On Parler, a pro-Trump call for Georgia runoff boycott threatens Mitch McConnell's plan to restrain Biden	1
t3_jzglva	Wreckage everywhere': can Biden undo Trump's harsh immigration policies?	u
t3_jymptl	Wisconsin officials: Trump observers obstructing recount	1
t3_jzpr6u	Trump Wants 3rd Circuit to Halt Pennsylvania Certification	1
t3_jypgsl	Trump's legal team requests recount of georgia presidential vote	1
t3_k0d1g3	'Well That Was Weird as Sh*t': As More States Certify His Defeat, Trump Holds 60-Second Briefing to Brag About Stock Market	1,4
t3_k0d7kj	Trump administration wants to cut food stamps to thousands of seniors, lawmakers say	4
t3_jz2mz3	Trump Campaign Didn't Request a Recount in Wisconsin Counties Using Dominion Machines	1
t3_jz3fxh	Claim that Trump 'was never given an orderly transition of power' is false	3
t3_jyxqd1	Chris Christie: Trump's legal team 'a national embarrassment'	7
t3_jynvr3	Detroit voters sue President Trump over his attempt to block certification of election results	1
t3_jyzjov	Chris Christie dismissed Trump's legal team as 'a national embarrassment'	7
t3_jzvxxd	Trump campaign loses 5 more cases in Pennsylvania Supreme Court decision	1
t3_jzj1p6	Group of Black voters in Detroit suing President Trump, citing voting rights abuses &amp; disenfranchisement	1,7
t3_jygs2r	G20 leaders meet to discuss help for poorest nations in post-Covid world, Trump golfs	5,7
t3_k01msh	Secret Service planning for Trump spending lots of his post-presidency in Palm Beach	u
t3_jzvetb	Report of a 'souring' relationship between Trump and Giuliani	u
t3_jzqca2	Trump scores two wins as Michigan legislature, federal appeals court agree to election reviews	1
t3_jy9v9p	In Georgia, Pence Walks Line Between Trump's Election Falsehoods And GOP Senate Fight	1
t3_jypw7q	Out of 53 Republican senators, only two have stood up to Trump's attempt to overturn the election	1
t3_jyiov7	For Netanyahu and Israel, Trump's Gifts Kept on Coming. Allowing the convicted spy Jonathan Pollard the ability to emigrate to Israel was just the latest in a long list of prizes for America's closest ally in the Middle East.	5
t3_jw7z9f	Petition circulating at Harvard to stop former Trump administration officials from attending, teaching or speaking at the university	7
t3_jygwhl	Donald Trump Improved Standing With Latinos In 78 Of America's 100 Majority-Hispanic Counties	u
t3_jzpvd8	Trump's bizarro-world 'elite strike force' legal challenge is about to implode	1
t3_jxtmra	'We are a nation of laws, not tweets': Republican Sens. Romney and Sasse decry Trump efforts to challenge election	7
t3_jy2bz3	Trump Administration Accused of Trying to Bully Banks Into Financing Arctic Fossil Fuel Extraction	4,6
t3_jyxn1c	Chris Christie: Trump's legal challenges against election results have been "a national embarrassment"	1,7
t3_jzq15s	Rush Limbaugh: Trump Needs to Hold Rallies in Georgia	u
t3_jzra8r	In blow to Trump, Michigan canvassing board certifies election results	1
t3_k0az01	Biden accuses Trump of 'outright cruelty' at the border as he introduces Homeland Security pick	7
t3_jy46k6	Letters to the Editor: Stop Donald Trump's coup. Impeach him again	7
t3_k0gw1d	Holman Jenkins: Media Hysteria Is the Trump Show	7
t3_jzfnh7	Trump's legal team cried vote fraud, but courts found none	1,7
t3_jz9k6j	Donald Trump's legal team has been a 'national embarrassment,' according to one loyal Trump supporter	7,1
t3_jyk7x7	Trump campaign again seeks to stop certification of Pennsylvania's election results	1
t3_jymhl2	Experimental drug given to Trump to treat covid-19 wins FDA clearance	2
t3_jzmb4c	Trump's True Feelings About Jews and Israel	5
t3_jyee44	Trump to lose @POTUS Twitter account on January 20	u
t3_jy1qop	After Trump meeting, Michigan GOP leaders say Biden's win still stands	1
t3_jzobu4	Behind the scenes, Trump frustrated with his legal team's maneuvers	1
t3_jxm95o	New York subpoenas Trump Organisation for details of consulting fees paid to Ivanka	u
t3_jzgzo5	Trump is not just refusing to concede, he is sabotaging nation's interest	3,7
t3_jxuny2	An Embarrassing Error by Trump's Legal Team	7,1
t3_jznbrr	U.S. Election: Trump legal team distances itself from lawyer after controversial comments - National | Globalnews.ca	7
t3_jxotoe	Trump's lawsuits plagued by spelling errors: 'I've never seen an election lawyer handle a case as poorly as Giuliani has'	7
t3_jyz56l	Trump rails against Paris climate accord in virtual G20 event	6,5
t3_k08lkd	Because of Trump sanctions, Western Union remittances come to an end in Cuba	5
t3_jyzt0i	Trump, as Always, Is Fighting, as Promised -- President Donald Trump is doing exactly what he promised his supporters he would do by fighting for every possible legal way to win the election.	1
t3_k0359b	It's over for Trump	u
t3_jvfouh	Ivanka Trump:  The media's near total silence about the physical violence being perpetrated against conservatives is dangerous"	u
t3_k04620	'Beyond an embarrassment,' legal experts say of Trump and Giuliani's floundering efforts in court	1
t3_k0gowa	The Trailer: A liberal on how he won in a Trump district	1
t3_jy853m	US Chamber of Commerce chief calls on Trump to stop delaying transition to Biden presidency	3
t3_jzus5d	Almost No Trump Voters Consider Biden the Legitimate 2020 Election Winner, Poll Says	1
t3_jyt5rw	Liz Cheney says Trump should respect 'sanctity' of election if he can't prove claims in court	1
t3_jyh2tm	Trump's 'Death Star' strategy: Forcing a fight over states' electors	7
t3_jz2pba	Small but growing number of Republicans tell Trump it's over:  Stop golfing and concede 	3,7
t3_k0feo8	Georgia Republican Voters Consider Boycott Of Special Senate Election In Support Of Trump	1
t3_jzop9w	Trump Jr. Warns Georgia Voters To Ignore Activists Encouraging Them Not To Vote In Senate Races: 'That is NONSENSE'	1
t3_jykqsr	Trump's Michigan election ploy: How it works, and why experts say it will fail	1
t3_jzqf5t	Republican Congressman Says GOP 'Embarrassing,' Calls on Party to 'Denounce' Trump's 'Conspiracy Theories'	1,7
t3_jyhe14	Trump tells G20 leaders he wants to work with them 'for a long time'	5
t3_jy0dkc	Donald Trump Jr. tests positive for COVID-19	2
t3_jziz6f	Trump will leave office soon. But we can't let him escape accountability for his misdeeds.	7
t3_jzucnl	How Trump's tweets inadvertently mobilized hundreds of thousands suburban women against him	7
t3_jxnvxb	After UN 'Database' Targets Israeli Settlements, Trump Administration to Blacklist BDS Supporters	5
t3_k0coc2	Trump is junking a treaty - and two planes - designed to stop nuclear war	5
t3_jycmh4	A destructive legacy: Trump bids for final hack at environmental protections	6,7
t3_jzjbng	In Another Country This Would Be Called a Coup: Detroit NAACP Head on Trump Trying to Overturn Vote	1,7
t3_jzu2rx	Michigan Certifies Election Results, Declaring Biden Winner In New Blow To Trump	1
t3_jxobzm	Poll: 61 percent of voters say it's important that Trump give concession speech	3
t3_jzzs16	GM abandons Trump's war against California's pollution powers	6
t3_jzt98m	Appeals Court Grants Expedited Review of Trump Campaign's Pennsylvania Lawsuit	1
t3_jxxo0f	Trump's efforts to flip Michigan election results raise significant legal, ethical questions: Experts	1
t3_jzv4kr	GM withdraws support for Trump lawsuit seeking to roll back auto emissions rules	6
t3_jz9obr	US election 2020: Trump ally urges him to accept defeat in US vote	3
