Name	title	coding
t3_jyrnq8	States and Local Republicans standing up to Trump are putting National GOP leaders to shame	7
t3_jxnig4	Obama joked that Trump might have to get dragged out of the White House by Navy SEALs if he keeps refusing to concede	"3,7"
t3_jz3dde	Trump is in an unprecedented streak of silence	7
t3_jy58b1	Senators who urged ‘voters to decide’ impeachment won’t admit Trump lost the election	1
t3_jys0wx	Trump campaign asks for another Georgia recount	1
t3_jx9880	Giuliani: 'Massive Fraud' Used to Steal Election From Trump	1
t3_jyp5q9	Actor Scott Baio threatens to move to Utah to unseat Sen. Mitt Romney after his anti-Trump tweet	U
t3_jzhlu7	"Trump's 'elite, strike force' legal team starts to shrink"	1
t3_jzrmc0	"Trump’s Ridiculous, Sloppy Coup Attempt Just Face-Planted in Michigan"	"1,7"
t3_k047z0	Press: Trump's biggest fear is — lock him up	7
t3_k03r9y	‘A passing attempt at adulthood’: Stacey Abrams gives scathing reaction to Trump finally starting transition	"3,7"
t3_jzsk0y	Congress Has Every Right to Keep Investigating Trump After He’s Gone	7
t3_jxtpep	"Trump Lawyer Sidney Powell Responds to Tucker Carlson: 'He Was Insulting, Demanding and Rude'"	U
t3_k05r0v	"Enough cowardice: Democrats must forge ahead, without caring what the Trumpers say"	U
t3_k0hsjx	"Fox News viewership slips post-election, prodded by Trump"	U
t3_jx82xb	'We no longer have' an 'honest press' -- Commentator: Media 'casually compares Trump to Hitler' because it's 'what they believe'	7
t3_jz2pci	Tapper: Judges are running out of pejoratives for Trump's legal efforts - CNN Video	1
t3_jzjwz1	100 Republican national security experts demand GOP admit Trump loss	1
t3_jzzepz	Trump dismantles decades-old surveillance treaty irreparably on his way out the door	7
t3_jz0eog	"In Public, Trump Still Claims He Won. In Private, Aides Say He’s Planning for Life After Presidency."	"1,3"
t3_jzmvi7	"Trump's on his way out, but leaves a lasting legacy: The right's open embrace of terrorism. How did the Kenosha shooter post $2 million in bail? Because conservatives are normalizing right-wing terrorism"	U
t3_jzpd7w	JUST IN: Third Circuit Court of Appeals Grants Expedited Review For Team Trump’s Appeal in Pennsylvania	1
t3_jzqca2	"Trump scores two wins as Michigan legislature, federal appeals court agree to election reviews"	1
t3_jz5lhv	Attorney Heading Up Trump Campaign's Wisconsin Recount Effort is Seeking to Throw Out His Own Vote	1
t3_k0gw1d	Holman Jenkins: Media Hysteria Is the Trump Show	7
t3_jyp2p0	Trump team requests recount of Georgia presidential vote	1
t3_jzfpdr	Donald Trump has assaulted our democracy	"1,7"
t3_jyj5z6	Detroit voters sue Donald Trump over unsubstantiated claims of voter fraud	1
t3_jzuvas	Report of a 'souring' relationship between Trump and Giuliani	U
t3_jyx06u	Election Updates: Trump Campaign Faces Major Legal Setbacks; Biden Wins Certified	1
t3_jyxlr4	Analysis: Donald Trump has left the world stage. Few will miss him	7
t3_k0cidk	Trump will pardon turkey after agreeing to presidential transition	"3,5"
t3_jzg8x4	'Elite Strike Force'? Trump Legal Team Throws Right-Wing Attorney Sidney Powell Under the Bus as Coup Attempt Flails	1
t3_jylbj0	CNN Condemns Trump Rallies As 'Physically Peaceful But Morally Violent'	7
t3_jz60sj	Dominion responds to Trump team claims	U
t3_jzrtvc	"N.Y. Times op-ed admits: Trump was correct, reopen the schools"	U
t3_jz7cgh	"Trump dumps Sydney Powell, lawyer who promised to ""blow up"" Georgia, as legal strategy unravels"	1
t3_jztm0i	"Trump Campaign’s Actual Argument in Appeals Court: We’re Only Trying to Disenfranchise 1.5 Million Voters, Not 6 Million Pennsylvanians"	1
t3_k025lg	Arizona Republican compares Trump election dispute with Japanese soldiers fighting after WW2 ended	1
t3_k00iks	Trump Dismantles Decades-Old Surveillance Treaty Irreparably On His Way Out The Door | Rachel Maddow	"3,5"
t3_jydj00	"LIVE: March for Trump in Atlanta, Georgia"	1
t3_k0dlm3	"Pennsylvania, Nevada certify election results for Biden despite Trump legal challenges"	1
t3_jypxr0	Trump requests recount in Georgia	1
t3_jyusgt	Ben Carson: Trump Saved My Life After I Got COVID	U
t3_jz1lvu	Trump seeks expedited appeal of Pennsylvania ruling against effort to toss mail-in ballots	1
t3_jzwrvx	NYT reporter Maggie Haberman thinks Trump's tweet is 'the closest to a concession' he'll give	"1,3"
t3_jyny1g	A Judge Demolished The Trump Campaign’s Effort To Undo Biden’s Win In Pennsylvania And Push Fraud Conspiracies	1
t3_jzua12	GSA notifies Joe Biden that Trump administration is ready to start transition process	3
t3_jyxl1z	How to explain Latino support for Trump? ABC News reports misleading memes went viral in Latino communities	U
t3_jznb23	How Trump placed a ticking time bomb at the center of our system	7
t3_jynvr3	Detroit voters sue President Trump over his attempt to block certification of election results	1
t3_jzj1p6	"Group of Black voters in Detroit suing President Trump, citing voting rights abuses &amp; disenfranchisement"	"1,7"
t3_jyjvqh	'A Disgrace': Trump's DOJ Schedules Three More Federal Executions in Days Before Anti-Death Penalty Biden Takes Office	7
t3_jzj73m	Trump’s press secretary Kayleigh McEnany heckled in briefing: ‘When will you admit you lost?’	1
t3_jz9k6j	"Donald Trump’s legal team has been a ‘national embarrassment,’ according to one loyal Trump supporter"	"1,7"
t3_jyhg8l	Trump appointed judges in Florida overturn ban on conversion therapy for minors	U
t3_k084zn	FNC's Laura Ingraham: 'I Would Be Lying to You' if I Said There Was an 'Excellent' Chance SCOTUS Delivers Victory to Trump	1
t3_k0feo8	Georgia Republican Voters Consider Boycott Of Special Senate Election In Support Of Trump	1
t3_jzr751	"Michigan board votes to certify the state’s election results, dealing Trump another blow"	1
t3_jxdwum	"Sidney Powell: Absent software fraud, Trump 'had at least 80 million votes'"	1
t3_jyzag6	"Chris Christie Calls Trump Legal Team ‘National Embarrassment,' Tells President to End Election Suits"	"1,7"
t3_jzvs4f	"Trump Tells GSA, and His Team, to Begin the Transition Process; Vows to ‘Keep Up the Good Fight’"	"1,3"
t3_jyi4xi	Impeach the president again — Removal from office wouldn’t be the goal this time. It would be to prevent Trump from running again.	7
t3_jzfqzc	"Do Trump-Supporters Live in an Alternate Universe? Actually a huge number of Americans have a false impression of reality because they are being told lies by their media. The people who constantly hear these lies do live in an ""alternate reality."""	U
t3_jyy8fq	"Biden to name first Cabinet picks Tuesday, as Trump bemoans swift actions"	3
t3_k0ek8c	Biden's foreign policy team lays out a national security vision that differs sharply from Trump's	5
t3_jzlzl3	"After looming so large in Washington, Donald Trump has shrunk into a small, petty man"	7
t3_jygwhl	Donald Trump Improved Standing With Latinos In 78 Of America’s 100 Majority-Hispanic Counties	5
t3_jzt9d7	"Trump’s Legal Team Tries (and Fails) to Disavow Conspiracy Theorist Attorney Sidney Powell: Unfortunately for Rudy Giuliani, Jenna Ellis, and the GOP, it’s not so easy to un-release The Kraken"	"1,7"
t3_k0fdxm	How Trump’s Strategy for Outpacing the Law Finally Fell Apart	1
t3_jyzt0i	"Trump, as Always, Is Fighting, as Promised -- President Donald Trump is doing exactly what he promised his supporters he would do by fighting for every possible legal way to win the election."	1
t3_jzmam7	Trump's top election lawyer in Wisconsin says he and his wife voted illegally in the campaign's latest legal argument	"1,7"
t3_jyxocz	Michigan leader: Trump didn’t ask for election interference	1
t3_jzlr1s	"The ""What happened in your state last week?"" Megathread, Week 46"	U
t3_jzzo0f	Trump is worried Giuliani and legal team are ‘fools making him look bad’	1
t3_jzo4ys	"To Prevent 'Active Sabotage' of His Agenda, Biden Urged to Clean House of Trump Loyalists on Day One"	3
t3_jzsjpm	Trump is reportedly worried that his legal team is made up of 'fools that are making him look bad'	1
t3_k0ghb4	"White House Reporter Reacts to Trump’s Minute-Long Briefing: ‘Well, That Was Weird as Sh*t’"	U
t3_jzvflg	Pennsylvania counties certify election results despite isolated pushback and baseless fraud claims from Trump allies	1
t3_jzo4tp	Journalist Carl Bernstein names 21 GOP senators who 'privately expressed their disdain' for Trump	7
t3_jyxqd1	Chris Christie: Trump's legal team 'a national embarrassment'	7
t3_jyjt9q	"Battered by failures to reverse Biden win, Trump, allies persist with fraud claims"	1
t3_k02wgo	Maxine Waters Pushes for Investigation of 'Criminal' Trump To 'Send a Message Across the World'	"5,7"
t3_jyunps	"Trump, laden with $400 million debts, plans to cash in on his post-presidency with a book deal, media appearances, and selling rally tickets, according to a report"	4
t3_jzw2s8	"Trump Tells GSA, and His Team, to Begin the Transition Process; Vows to ‘Keep Up the Good Fight’"	3
t3_jytan4	Detroit voters sue President Trump over his attempt to block certification of election results	1
t3_jy0s0y	DeSantis and Bondi disappear as Trump’s election challenges grow desperate and chaotic	1
t3_jzmb5h	Detroit had more vote errors in 2016 when Trump won Michigan by a narrow margin. He didn’t object then.	1
t3_jzv4mr	The post-Trump politics of Covid	"2,3"
t3_jz6vh9	"Murkowski tells Trump: ""It is time to begin the full and formal transition process"""	3
t3_jyagwt	Opinion: About that page of pro-Trump letters...	U
t3_jzqpbm	Rush Limbaugh criticizes Trump legal team for promising 'bombshells' and failing to deliver	1
t3_jyby0o	Trump Announces Groundbreaking Rules to Lower Prescription Drug Prices	4
t3_jzv6i4	‘Bye bye Trump’: Ilhan Omar and others celebrate as president finally begins transition	3
t3_k0cb1h	"Hawley 2024? Missouri Republican could be ‘Trump 2.0,’ say conservative supporters"	U
t3_jzgsx3	"Trump legal team says Sidney Powell had no formal role, but record shows they loved her involvement"	U
t3_jzqrf3	Bernstein names 21 Republican senators who privately expressed contempt for Trump	7
t3_jy7n7y	Conservative News Site Warns Trump: 'Concede And Move On'	3
t3_jyn27t	FDA authroizes emergency use of Regeneron antibody treatment given to Trump	2
t3_k02329	Revealed: Trump Officials Rush to Mine Desert Haven Native Tribes Consider Holy	U
t3_jzjzln	A Neighbor You Like Probably Voted For Trump	U
t3_jvbi4h	Obama Compares Trump To A Dictator Who Thinks He ‘Can Kill People’ And ‘Suppress Journalists’ In 60 Minutes Interview	7
t3_jzka2y	Pro-Trump Attorney Urges Republicans Not to Vote in Georgia Runoff	U
t3_jzc3y4	More Republicans are losing patience with Trump's legal absurdities	1
t3_jz0mhl	Trump’s wildest claims are going nowhere in court. Thank legal ethics. Thank legal ethics. The president’s lawyers can’t make assertions without evidence in front of judges.	1
t3_jzt6dy	Appeals court to review Trump's Pennsylvania case -- Legal team on track with plan to reach Supreme Court	1
t3_jyv0um	FDA Grants Emergency Use Authorization To Antibody Cocktail Used By Trump	2
t3_jzo44d	Two years ago this week Trump was mocking a turkey for refusing to concede an election	"1,7"
t3_jzlacq	Donald Trump finally found someone with a too-crazy conspiracy theory about the 2020 election	1
t3_k00s3i	Vt. AFL-CIO OKs strike if Trump refuses peaceful transfer of power	3
t3_jxw6ms	Trump is trying to overturn an election he didn't win. We didn't get here by accident	1
t3_jyr204	Trump campaign files for new recount in Georgia	1
t3_jyk59x	Wisconsin officials: Trump observers obstructing recount	1
t3_k028s9	"Roger Stone-Tied Group Threatens GOP: If Trump Goes Down, So Does Your Senate Majority"	U
t3_jzexod	Trump and Fox News Are at War and Democrats Can't Decide What to Do About It	U
t3_jzb2zh	"Twitter Afire After Trump Camp Breaks With Lawyer: Lasted ‘About Half A Scaramucci’ | “Sidney Powell should refuse to concede her position from Trump’s legal team,” one critic joked."	1
t3_jzq15s	Rush Limbaugh: Trump Needs to Hold Rallies in Georgia	1
t3_jzqzld	"Trump campaign forces Georgia taxpayers to pay for second recount after first one confirms its loss. A hand recount of nearly 5 million votes confirmed Biden's win, but Team Trump wants to milk taxpayers even more"	1
t3_jzis32	Carl Bernstein named 21 GOP senators who he said are enabling Trump's attempts to subvert US democracy by only criticizing him in private	1
t3_jyj1x6	'GOP made a bed of nails': Scaramucci on Republicans appeasing Trump	7
t3_jzpdpe	Trump's election lawsuit leads to 3rd Circuit grant for expedited review	1
t3_k00f2c	"No mea culpa for all the bad blood, but Trump has bowed to public pressure"	U
t3_jzlipn	Sidney Powell Stricken from Trump’s ‘Elite Strike Force’ Legal Team 8 Days After President Called Her ‘Wonderful’	1
t3_k0ex0g	Dominion Executive: Trump is not going to win. I made f***ing sure of that.	U
t3_k081u3	"Kash Patel, recently installed Trump loyalist, now leading Pentagon transition"	3
t3_k0b68g	Trump Had Less of an Impact on the World Than You Might Think	5
t3_k0az01	Biden accuses Trump of ‘outright cruelty’ at the border as he introduces Homeland Security pick	3
t3_jznr0d	Appeals Court Grants Expedited Review of Trump Campaign's Pennsylvania Lawsuit	1
t3_jykyw7	Federal Election Commission Chair: Trump Campaign Has Legitimate Claims of Election Fraud	1
t3_jy6dsk	"Two weeks after Biden named President-elect, Trump faces stinging setbacks"	3
t3_jyobi4	Michigan Legislators Face Calls For Possible Criminal Charges After Meeting With President Trump On Certification	U
t3_k0e454	Paul Ryan calls on Trump to concede and end lawsuits	1
t3_jzbqm7	"Trump campaign demands recount, signature matching in Georgia"	1
t3_jxscv0	Tucker Carlson calls out Trump's election lawyer for refusing to show evidence supporting the president's baseless voter fraud claims	1
t3_jznjcm	"Post-Trump, his party and his favorite network have to figure out their relationship with reality"	1
t3_jzis4d	Will Trump’s Accusers Finally Get Their Day In Court? | He soon will be unable to hide from the women suing him for defamation.	7
t3_jz6p3p	‘Stop Golfing And Concede’ | Gov. Larry Hogan Hits Back At President Trump’s Tweet On South Korea COVID-19 Tests	"1,3"
t3_jzpowr	Let’s hear it for the judges for dismissing Trump’s lawsuits	1
t3_jzo75x	GM hits reverse on Trump effort to bar California emissions rules	6
t3_jz0b6y	Claim that Trump 'was never given an orderly transition of power' is false	3
t3_jzfuso	Trump team falsely claim he was not assisted in transition by Obama	3
t3_jxyuk9	Trump Makes Late-Term Bid to Lower Prescription Drug Costs	4
t3_jz6fej	Trump campaign attempts to distance from conspiracy-theorist lawyer Sidney Powell	1
t3_jxv07i	"Ivanka Trump: How Dare You Investigate My Father for Tax Fraud, Which He Definitely Didn’t Use Me to Commit"	4
t3_jxvrvz	Nancy Pelosi calls Trump a 'psychopathic nut' as the president continues to try to overturn the election results	"1,7"
t3_jxsxuq	National Democratic Party official suggests re-education for Trump supporters: 'How do you deprogram 75 million people?'	1
t3_jy2k5b	Michigan attorney general ponders criminal probes of state and local officials who bend to Trump’s will on overturning election results	1
t3_jyzjg9	Congresswoman Liz Cheney is the latest Republican calling on Trump to prove fraud claims in court	1
t3_jz227v	"GOP Senator Has Instructed Staff to Cooperate With Biden Transition, Says It's 'Past Time' for Trump to Do Same"	3
t3_jziwyr	"What if Trump won’t leave the White House? A hostage negotiator, an animal-control officer, and a toddler whisperer have advice"	3
t3_jz56nz	GOP senator says Trump to Biden transition should begin 'tomorrow morning'	3
t3_jz1j6s	Missing links: Trump goes golfing in middle of G20 summit	U
t3_jzlkzv	‘Strongmen’ Scholar Explains Donald Trump’s Authoritarian Weaponization of the Legal System	7
t3_jzj8y9	Republican pollster: Trump's false 'rigged' election claims may hurt GOP chances of keeping Senate	1
t3_jzvdc2	An OAN Host Has Been Helping Rudy With Trump’s Legal Efforts	1
t3_jyu2fl	The federal toll of Trump's failure to lead	7
t3_jzjbne	"Sidney Powell Confirms Non-Affiliation With Trump Legal Team, Vows to Continue Fraud Fight"	1
t3_k05u50	Glum Laura Ingraham Tells Fox Viewers It’s Done: ‘I’d Be Lying’ If I Said Trump Still Had A Chance	1
t3_jxuobg	Trump's legal team seemingly didn't notice its allegation of election fraud in Michigan is based on data from Minnesota	1
t3_jz7frn	Trump Campaign Formally Requests a Recount in Georgia	1
t3_jyoy6m	Biden to ‘Racist’ Trump Voters: ‘Let’s Heal.’ That’s Easy for Him to Say.	3
t3_jze7ee	Trump repeats unfounded election fraud claims in late-night posts flagged by Twitter	1
t3_jyga4y	Judge rules against Trump global media chief after firings	U
t3_jz3r4j	Trump appeals rejection of effort to block Pennsylvania vote	1
t3_jyn1np	"GOP civil war inspired by Trump grips Georgia, threatens other states"	1
t3_jypr6w	"The final days of lame-duck Trump: Electioneering, revenge and environmental attacks as the president refuses to go quietly"	1
t3_jzpbaz	"General Motors Reverses Course, Spurns Trump-Backed California Emissions Lawsuit"	6
t3_jxny9j	Trump Legal Adviser Jenna Ellis Rips Media: ‘You Are Not Unbiased Jurors’	1
t3_jzmeyu	New report details Trump effort to seize thousands of acres of private land for border wall	5
t3_jz3tl3	Michael J. Fox says Donald Trump has played on 'every worst instinct in mankind': 'Biff is president!'	7
t3_k0bzv9	"Trump Stress-Tested the Election System, and the Cracks Showed"	1
t3_k0dppr	Wisconsin Republicans Blame Mark Zuckerberg for Trump’s Loss in Lawsuit	1
t3_jxtalp	Intimidation Tactics Against Trump Lawyers Undermine Justice	1
t3_jyvt2z	Wisconsin officials: Trump observers obstructing recount | Election officials overseeing the recount of presidential votes in Wisconsin’s largest county are accusing observers for President Donald Trump of unduly slowing the process	1
t3_jyeh3g	Trump’s last-ditch efforts to overturn results fail to make dent in Biden victory	1
t3_k02obo	Opinion | Guess Whose Votes Trump Doesn’t Want Counted	1
t3_jy0cbd	Opinion | Georgia Certifies: Donald Trump Lost	1
t3_jz1pj8	Mao’s Lesson for Trump’s America | Beware of leaders willing to set their own country on fire.	7
t3_jvz66c	"Trump orders Pentagon to pull 2,500 troops from Afghanistan and Iraq"	5
t3_jx2ieq	"New York Times op-ed admits 'Trump was right,' Democrats 'wrong,' about keeping schools open ""Some things are true even though President Trump says them"""	U
t3_jy8kt6	"Obama to produce Netflix series about Trump transition, unclear whether it will include abusing intel agencies to spy on successor"	3
t3_jxxtr7	Trump lawyers cited Minnesota counties in affidavit about Michigan: report	1
t3_jzo3o9	How Trump's destructive behavior emboldens authoritarian leaders abroad	5
t3_jziqei	"Team Trump Fired QAnon Lawyer Sidney Powell But She's Tweeting Through It - Last week she was part of Trump's ""elite strike force."" Now she's ""practicing law on her own."""	1
t3_jzfulz	Republicans as a multicultural working class party? That's Trump-level delusional thinking.	7
t3_jxgcqs	"Georgia recount results: Biden still ahead by 12,000 — but Trump has one last roll of the dice"	1
t3_jygnh6	"Here’s when Biden’s win becomes official — and how Trump is trying to prevent that | With key deadlines looming, derailing the certification of results is part of the president’s strategy"	1
t3_jyoleb	Kayleigh McEnany said Trump wasn't given an 'orderly transition of power' in 2016. He was.	3
t3_jzt98m	Appeals Court Grants Expedited Review of Trump Campaign's Pennsylvania Lawsuit	1
t3_jywaur	"3 ‘dead’ Georgia voters in fact very much alive: Trump, Tucker Carlson get it wrong"	1
t3_jzms1q	Pro-Trump Attorney Lin Wood Urges Republicans Not To Vote In Georgia Senate Runoff -- Unless GOP candidates help overturn the presidential election results in the state.	U
t3_jym2qo	"Duty or Party? For Republicans, a Test of Whether to Enable Trump"	7
t3_jyh4cs	"As world leaders meet to talk pandemic, Trump checks out and hits the links"	"2,5"
t3_jzlbdp	Trump friend and adviser Steve Schwarzman recognizes Biden as President-elect	3
t3_jyd52j	Twitter to Meet With Biden Transition Team on Transfer of Social Media Accounts From Trump Admin	3
t3_jzjyaw	"Trump EPA removes tool states use to protect farmworkers, environment"	6
t3_k02n7d	Should Trump Be Prosecuted?	7
t3_k00vjg	Analysis: Trump is leaving minority votes on the table	U
t3_jyn4xj	Trump campaign statement on Pennsylvania ruling	1
t3_jz2pba	Small but growing number of Republicans tell Trump it’s over: “Stop golfing and concede”	1
t3_jyb15a	"U.S. exits Open Skies treaty Sunday, but could Biden undo Trump's withdrawal?"	3
t3_jyiy24	"McEnany: Trump's Path To Victory Is Supreme Court, Exposing 'Systemic' Voter Fraud"	1
t3_k0c01b	How Trump’s conspiracy theories have inspired some supporters to boycott the Georgia runoffs	1
t3_k0dwtt	75% of every donation to Trump's leadership PAC could actually be spent by the president himself on things like paying family members or financing a 2024 bid	U
t3_jzaxgb	Trump campaign files narrow appeal in Pennsylvania - It is seeking permission to reframe its argument again.	1
t3_jztemd	Hear Rush Limbaugh criticize Donald Trump's legal team	1
t3_jzaqqe	An statement from Senator Toomey regarding the Pennyslvania Federal Court decision regarding the Trump campaign lawsuit.	1
t3_jyztx6	Do Trump Supporters Live in an Alternate Universe?	7
t3_jynp3x	"Trump Orders Hasty Afghanistan, Iraq Drawdowns to Beat Biden Inauguration"	5
t3_jo38f6	"In reference to those 133,889 votes that came in 100% for Biden:"	1
t3_jyqcfr	"After Pennsylvania court defeat, Trump faces new pressure to concede election"	1
t3_jyxu4b	Biden advisor: 'He does not have any concern' about Trump lawsuits	1
t3_jxrs4e	"Republican Party sparks backlash with ""Trump won by a landslide"" post: ""What happened to you?"""	1
t3_jypjqa	Merkel's Germany Tells Trump Not to Bring Troops Home from Afghanistan	5
t3_jzrp6i	Can Democrats Win Georgia Without Trump on the Ticket?	U
t3_jzzay5	Trump Won't Budge From Veto Threat Over Renaming Bases Honoring Confederates	U
t3_jzqk4b	Secret Service members asked about protecting soon-to-be-former president Trump full time in Florida: Sources | Agents in Trump's detail have been asked about relocating to West Palm Beach.	U
t3_jz3bhq	Pennsylvania election: Trump appeals dismissal of bid to block vote certification	1
t3_jziz6f	Trump will leave office soon. But we can’t let him escape accountability for his misdeeds.	7
t3_k061wu	Republicans With Any Love of Country Must Acknowledge That Trump Has Lost	1
t3_jz5jzx	Trump campaign says Sidney Powell not a member of legal team	1
t3_jxsfmb	Whoa: Nearly a Third of Democrats Believe the Election Was Stolen From Trump	1
t3_jyw2mu	Trump threatens to wreak havoc on the GOP from beyond the White House	3
t3_jydzd2	Twitter says it will hand control of US president's official account to Joe Biden on January 20 - regardless of whether Donald Trump has left the White House	3
t3_jylfat	Hispanic Voters In Florida Who Fled Dictatorships Think The Election Was Stolen From Trump	1
t3_jyys5f	Republican Gov. Larry Hogan is 'embarrassed that more people in the party aren't speaking up' against Trump's refusal to concede	"1,7"
t3_jy30hq	"U.S. Sen. Marsha Blackburn, a Trump ally, refers to Biden as 'president-elect'"	3
t3_jzuvjc	Trump Administration Begins Transition Process	3
t3_jxuc2q	Trump Is No Longer the Problem. His Army of Followers Is.	7
t3_jyzr2m	A Republican judge just tore into Trump’s election lawyers for their incompetence. Trump’s lawyers asked a judge to disenfranchise nearly 7 million voters. It ended badly for Trump.	1
t3_jvv0u2	Trump supporters vandalized a car . O no shit the owner did it with ties to BLM	7
t3_k0flki	Mueller Probe's Andrew Weissmann Wants Biden DOJ to Prosecute Trump	1
t3_jxqqb8	Ivanka Trump’s Rage-Tweets About Ongoing Tax Fraud Investigations Have Serious Potential to Hurt Her Legal Defense	U
t3_jzorhc	"Trump fears Giuliani, other lawyers in Biden vote challenge are ‘fools that are making him look bad’"	1
t3_jzk9j0	"Sidney Powell Responds to Trump Campaign's Statement Saying She's Not Part of Legal Team -- Powell said her fight will go on anyway and closed her statement with the hashtag, ""#KrakenOnSteroids"""	1
t3_k0hgs2	Facts Matter: Trump's Game Plan to Win	1
t3_jzsfv2	Obama calls Trump era an 'anomaly' in Canada-U.S. relations	7
t3_jziow1	Facebook will give presidential accounts to Biden even if Trump refuses to concede election	3
t3_jy0f6f	Donald Trump Jr tests positive for coronavirus	2
t3_jyauqo	Conspiracy theories are Trump ‘weapons’ in desperate bid to cling to power	1
t3_jyj6sy	AP Fact Check: Trump's flailing effort resting on mendacity	1
t3_jy91dn	"The Damage Trump Could Do Before the Inauguration - Some of his methods would be immediately evident; others, hidden."	3
t3_jyl6g3	Let Trump Off the Hook in the Name of Elusive Unity? Some Critics Say That Could Be a Big Mistake	U
t3_jzvrkx	Trump came in promising so much winning. He’s going out with so much whining.	"1,7"
t3_jybm3w	Trump maintains unproven 'massive' fraud claim after meeting with Michigan lawmakers	1
t3_jz5yna	Trump Campaign Disavows Its Own Election-Conspiracy Lawyer	1
t3_jzmemb	Trump Lawyer Tries To Toss Out His Own Vote In Wisconsin Recount	1
t3_jzgz98	John Kasich Stunned GOP Isn’t Defending Democracy Against Trump	1
t3_jysprc	FDA Grants Emergency Use Authorization To Antibody Cocktail Used By Trump	2
t3_jyg71f	NAACP Federal Suit: Trump Violated Voting Rights Act	1
t3_jyfjeg	"Most GOP Senators Stay Mum on Trump's Efforts to Challenge Election, After Washington Post Contacted All 53 of Them"	1
t3_jz1j0x	Chris Christie: Trump’s Legal Team Has Been a ‘National Embarrassment’	"1,7"
t3_jzhzmd	Reporter Carl Bernstein names 21 GOP senators who 'repeatedly expressed extreme contempt for Trump'	7
t3_jyy0a9	Trump election challenges sound alarm among voters of color	"1,7"
t3_jywg26	Trump seeks expedited appeal of Pennsylvania ruling against effort to toss mail-in ballots	1
t3_jzo8pn	GM flips to California's side in pollution fight with Trump	6
t3_jzmvum	Appeals Court Grants Expedited Review of Trump Campaign's Pennsylvania Lawsuit	1
t3_jysta7	Trump camp's lawsuit struck down in Pennsylvania	1
t3_jz3pdw	Wisconsin officials: Trump observers obstructing recount	1
t3_jyhsxr	Brian Williams mocks Geraldo Rivera suggestion to name COVID-19 vaccine after Trump	2
t3_jyftsx	"Trump’s Pennsylvania Suit is ‘Incoherent Conspiracy,’ Voters Say"	1
t3_jyhhtr	"McEnany: Trump's path to victory is Supreme Court, exposing 'systemic' voter fraud"	1
t3_jyqh97	"Chinese Warn Against Communism at Trump Rally, Tell Americans to Speak Out"	5
t3_jxqij2	Trump’s Lawyer Sidney Powell Is Hardcore QAnon: Her performance at Thursday's press conference was virtually a recitation of QAnon’s greatest hits.	1
t3_jzhsuf	Trump urges state legislatures and courts to ‘flip’ results	1
t3_jxvhyz	Lin Wood: President Trump won 400 electoral votes | One America News Network	U
t3_k055sr	Republicans sold out democracy to appease Trump's loser tantrum	1
t3_jyhv9o	Trump was pictured on his Virginia golf course during a coronavirus meeting for G20 leaders	"2,7"
t3_jyhqa5	Trump’s failure to work with Biden is becoming more urgent as Covid spreads	"2,3"
t3_jzpxxu	Biden taps Blinken to reshape U.S. foreign policy in post-Trump era	3
t3_jzexf7	Trump’s gains in North Philly show Latino voters are not a ‘gimme’ for Democrats	U
t3_jz38b8	"In Wisconsin recount, Trump challenges pile up, slow tally"	1
t3_jzsxow	Trump Lawyer: Michigan Legislature Agrees to Hold Election Review Hearings	1
t3_jzntq8	GM flips to California’s side in emissions lawsuit against Trump admin	6
t3_jye9pq	"What to make of more than 70m Americans who voted for Trump? — As of today, 73,781,603 people voted for Trump, which amounts to 47.2 percent of the total votes counted."	U
t3_jzicud	"Here Comes the Biden Blame Game - If the double-dip recession hits next year, Biden will remind us over and over that it’s Donald Trump’s fault. He’ll be wrong."	4
t3_jyw4pb	"Trump’s legal team cried vote fraud, but courts found none"	1
t3_k01f68	Watch Laura Ingraham Finally Tell Fox News Viewers That Biden Beat Trump	3
t3_jytj5f	"Trump or No Trump, Religious Authoritarianism Is Here to Stay"	U
t3_jyi5ye	Trump goes golfing in middle of G20 summit	7
t3_jzpr6u	Trump Wants 3rd Circuit to Halt Pennsylvania Certification	1
t3_jy9wy2	Counted out: Trump's desperate fight to stop the minority vote	1
t3_jytpjk	Pa. Senator Pat Toomey Says President Trump Has 'Exhausted All Plausible Legal Options'	1
t3_jz68im	Why a federal judge threw out Trump's Pennsylvania election lawsuit	1
t3_jz37gc	Trump Derangement Syndrome in Democrats won't go away with Trump	1
t3_jz3cid	Can Republicans Get Trump-Style Turnout Without Trump on the Ballot?	U
t3_jzs06l	"Michigan certifies Joe Biden's win despite Trump's GOP overtures | The Board of State Canvassers, which has two Republicans and two Democrats, confirmed the results on a 3-0 vote with one abstention"	3
t3_jz1k5h	Trump team making false argument about his 2016 transition	3
t3_jzrspx	'Special jeopardy': 100 former Republican national security officials warn Trump must allow transition	3
t3_jznpy5	Trump set on veto of defense bill over renaming bases honoring Confederates	5
t3_jzjhoa	Republican former national security officials urge party to demand Trump concession	3
t3_jxss00	Bob Corker: Republicans ‘have an obligation’ to challenge Trump’s voter fraud allegations	1
t3_jvf840	BLM activist who sucker-punched Trump supporter is a registered child sex offender	U
t3_jyk7x7	Trump campaign again seeks to stop certification of Pennsylvania's election results	1
t3_jyn8ch	"FDA authorizes Regeneron's Covid treatment, taken by Trump, for emergency use"	2
t3_jyxl4z	"Trump ally, former NJ governor Chris Christie: president’s election fraud claims are a ‘national embarrassment’"	"1,7"
t3_jy56dt	Trump Announces New Regulations Lowering Prescription Drug Costs	4
t3_jyarxl	Neal Katyal: All of Trump’s criminal immunity expires in about 60 days	7
t3_jyvp5p	"Federal judge rejects Trump campaign's Pa. lawsuit with prejudice, saying it lacks factual proof"	1
t3_jy1gsg	Harvard petition demands scrutiny of ex-Trump officials	7
t3_jz3fxh	Claim that Trump 'was never given an orderly transition of power' is false	3
t3_jz28w0	"Trump election challenges sound alarm for Black voters in Detroit, Philadelphia, Atlanta"	1
t3_jya5eq	Culture wars fuel Trump’s blue-collar Latino gains: “Most Latinos identify first as working-class Americans. And Trump spoke to that.”	U
t3_jznbrr	U.S. Election: Trump legal team distances itself from lawyer after controversial comments - National | Globalnews.ca	1
t3_jyqqwc	FDA authorizes emergency use of the antibody cocktail given to Trump to treat Covid-19	2
t3_jzverf	"Trump’s Case is a Constitutional One, Sidney Powell's is a Criminal One"	1
t3_jyxinl	France's Le Drian says he shares Biden's view of Trump's challenge as irresponsible	5
t3_jzguka	"Trump handing Taliban a victory on his way out, says former national security adviser H.R McMaster"	5
t3_jybgkx	Op-Ed: How Biden can restore U.S. global leadership after Trump's retreat from international institutions	3
t3_jzveqg	National Embarrassment Donald Trump Worried Lawyers Are Sullying His Pristine Reputation	7
t3_jywxtu	Michigan GOP Congressman Tells Trump 'It's Over': 'The Voters Spoke'	1
t3_jzk5a1	A Circuit Breaker on Election Night? (...nearly 30 percent of Democrat voters think the election was stolen from Trump)	1
t3_jyyf6p	"'Unacceptable': Wisconsin Election Officials Say Trump Observers Hindering Recount With Constant Interruptions, Questions"	1
t3_jzloh0	Watergate journalist Carl Bernstein outs 21 Republican senators who 'privately' expressed 'extreme contempt' for Trump.	7
t3_jy0r0u	Obamas producing Netflix anti-Trump comedy show	7
t3_jyzg9r	Rudy Giuliani says election case losses help Trump campaign’s strategy to get ‘expeditiously’ to Supreme Court	1
t3_jz4ivr	Nearly all Pa. counties expect to sign off on election results by Monday despite Trump’s attempts to delay certification	"3,5"
t3_jysfhm	"Trump campaign requests recount of hand-recounted results in Georgia, which is unlikely to change outcome"	1
t3_jyaufj	Berkeley professor sparks outrage by claiming Trump supporters who have an 'indifference' to COVID are like Germans who 'ignored and profited from the Holocaust'	2
t3_jzo5py	G.M. Drops Its Support for Trump Climate Rollbacks and Aligns With Biden	6
t3_k08cy8	Trump campaign continues to fight as more evidence of voter fraud emerges	1
t3_jztvos	Megathread: The GSA Has Informed President-Elect Joe Biden that the Administration is Ready to Begin the Formal Transition Process	3
t3_jz8bvm	"Native American voters across Minnesota turned out to oust Trump - Vote totals were up around Red Lake, and 90% for Biden"	U
t3_jzrmfo	"Who is Sidney Powell, the lawyer the Trump campaign is now distancing itself from?"	1
t3_jyebbg	"GOP asks Michigan not to certify election results, citing ‘irregularities’ | The move follows speculation that Trump is seeking to persuade Michigan Republicans to override election results"	1
t3_jzs2sh	Carl Bernstein says 21 Republican members of U.S. Senate have expressed disdain for Trump	7
t3_jyar6j	Coronavirus updates: Donald Trump Jr. tests positive; model estimates 471k US deaths by March; Cuomo to receive International Emmy	2
t3_k0c237	"As he ignores election defeat, Trump to pardon turkey"	5
t3_jyyjwi	Full Cramer: 'Past time to start a transition' but Trump still has a right to challenge	1
t3_jz5hlr	Chris Christie rips Trump's legal team as ‘national embarrassment’	7
t3_jwiqp0	BLM Thug Who Sucked-Punched Trump Supporter Is a Convicted Child Rapist	U
t3_jzud9p	Bernstein names 21 Republican senators who privately expressed contempt for Trump	7
t3_jy8q5v	"NJ Democrat Calls for Rudy Giuliani, Other Trump Attorneys to be Disbarred"	1
t3_jzj1yp	"Major business leaders reportedly signed a letter urging Trump to concede, and warn that 'our democracy grows weaker' the longer the presidential transition is delayed"	1
t3_jy1crk	Trump Touts New Rules to 'End Global Free Loading' of Prescription Drugs	4
t3_jznqim	"Explainer: Despite Trump claims, voter fraud is extremely rare. Here is how U.S. states keep it that way"	1
t3_jyxs1k	Lobster biz hopes for stability after tumultuous Trump era	3
t3_jzitza	"Why The Left Can Be So Ridiculously Self-Righteous Without Realizing It -- What we saw in the lead up to the elections, and what we’ll witness for years to come, is utter contempt for Trump voters and conservatives in general."	U
t3_k0e8yx	"Poll Shows Media Censorship Cheated Voters of Vital Info, Robbed Trump of Second Term"	1
t3_jzq2dw	Poll: Majority say Trump should concede	1
t3_jzjq3y	Michigan GOP Threatens to Delay Election Certification as Trump Continues to Challenge Results	1
t3_jymtbq	Megathread: Judge Dismisses Trump Lawsuit Seeking to Delay Certification in Pennsylvania	1
t3_jz0o5f	Trump: Biden would 'kill the American economy' in rejoining climate treaty.	4
t3_jz6cus	Trump campaign purges conspiracy-theorist Sidney Powell from legal team	1
t3_jygj58	Joe Biden Turns 78 and Will Be the Oldest President — After Trump Broke the Record Right Before Him	3
t3_jzinf3	Trump Team Dumps Sidney Powell As Attorney Peddles Bonkers Conspiracy Theories About Election	1
t3_k0ei4s	Dan Bongino hints at potential run for president in 2024 if Larry Hogan runs and no Trump does	U
t3_jzquzq	"GOP senator: No indication of widespread voting irregularities, window for Trump challenges is 'closing'"	1
t3_jykt2t	"Trump forges ahead with frantic effort to overturn election | Having exhausted many of his legal options, Trump is looking at other ways to subvert Joe Biden’s victory."	1
t3_jxu9tg	Wisconsin’s Recount Will Only Serve to Confirm Donald Trump’s Humiliating Defeat	1
t3_jxs3ay	Trump Camp Outraged Georgia Recount Counted The Votes	1
t3_jy240e	"How Christianity Gained Cultural Momentum In The Trump Era -- Some celebrities are not just talking the talk, but they seem to be walking a walk that seems to counter what Hollywood culture promotes and accepts."	U
t3_jzt28a	GM quits Trump lawsuit against California auto emissions rules	6
t3_jxtigq	"I’m Garrett M. Graff ＆ I’m the executive producer of ""While the Rest of Us Die: Secrets of America’s Shadow Government"" on VICE TV, uncovering the US’s top secret Doomsday plans from the natural disasters to nuclear strikes to civil unrest. I’m here to answer your worst case scenario questions. AMA."	U
t3_jzhcb0	"What if Trump never concedes? The Constitution will end his term, conservative lawyer John Yoo says"	1
t3_jy94n0	"Trump considers targeting birthright citizenship with executive order in his last weeks in office, report says"	3
t3_jzoam2	Reality Forecloses on the Trump Presidency | A fading campaign collapses under the weight of finally having to back up big talk with actual substance.	1
t3_jy3mhv	Biden's margin of victory over Trump surpasses 6 million votes	3
t3_k0fd6y	"Demanding Reversal of Trump Cruelty, Immigrant Rights Groups Welcome Biden Pick of Mayorkas for DHS Secretary|The former director of U.S. Citizenship and Immigration Services was a key architect of the Deferred Action for Childhood Arrivals program"	3
t3_jzntsc	GOP Former National Security Officials Urge Party to Demand Trump Concession	1
t3_jzr88b	"Michigan election board certifies 154,000-vote victory for Joe Biden, another setback in Trump’s effort to overturn election results"	1
t3_jy4x55	Harvard Students Demand That Trump Officials Be Preemptively Barred From Campus	7
t3_jxrtap	Trump’s Indifference Amounts to Negligent Homicide	7
t3_jzfp15	Trump’s Anti-LGBTQ Agenda Has Been Hidden in Plain Sight	U
t3_jznx2m	Biden signals shift from Trump with national security picks	3
t3_jy0een	Rudy Giuliani's Son Potentially Exposed Most of Trump's Legal Team to COVID During RNC Press Conference	2
t3_k0flpb	Hunter Biden Arrives At White House Dressed As Turkey In Hopes Of Being Pardoned By Trump	U
t3_jysdc9	Body Language - Obama Advice To President Trump	3
t3_jy853m	US Chamber of Commerce chief calls on Trump to stop delaying transition to Biden presidency	3
t3_jy2j68	Arizona’s largest county certifies Biden win over Trump	5
t3_jzok9t	Bernstein names 21 Republican senators who privately expressed contempt for Trump	7
t3_jzvydq	Trump administration pulls out of Open Skies treaty with Russia	5
t3_jy12xd	"Michigan GOP leaders after Trump meeting: ""We will follow the law"""	1
t3_jyo5jb	"Pa. Sen. Toomey congratulates President-elect Joe Biden, calls on Trump to begin transition"	3
t3_jy2rb5	Trump lifts travel ban on Chad	5
t3_jy06aa	"After Trump meeting, Michigan GOP lawmakers say they’re not aware of any info that would change Biden’s victory in state"	1
t3_jzgh8i	Antony Blinken: Biden's secretary of state nominee is sharp break with Trump era	3
t3_jzfkg5	'Too crazy' for Trump: Fact-checking the president's legal team's wild conspiracy theory	1
t3_k0h7fo	Geraldo Rivera to fellow Trump supporters: ‘We lost’	3
t3_jzlw9g	Trump has tested the limits of the US constitution – but it's still holding | US elections 2020 | The Guardian	1
t3_jzbggz	"The Motley Crew Leading Trump’s Election Challenges | Jared Kushner wanted a “James Baker-like” figure, but he ended up with a ragtag bunch of lawyers led by a raving Rudolph Giuliani, who made his first appearance in federal court in this century."	1
t3_jz90wi	Obamas Collaborating on Anti-Trump Netflix Serie	7
t3_jyhjr0	Trump skips G20 coronavirus meeting to play golf and tweet bogus election claims	"5,7"
t3_jzos3p	It’s Time To Consider Sanctions for Trump’s Legal Team	1
t3_jz5ofk	Giuliani distances Trump campaign from attorney Sidney Powell	1
t3_jyjte3	Ilhan Omar Urges Biden to ‘Reverse’ President Trump’s Middle East Agreements -- Thinks that peace between Israel and Arab nations is a bad thing.	5
t3_jxn3k4	Trump reportedly told an ally he knows he lost the 2020 election but wants revenge on Democrats for disputing his 2016 win	7
t3_jzna59	"New Trump rule may require some African tourists to pay up to $15,000 in bonds"	"4,5"
t3_jz7fr3	Latest: Why a Federal Judge Tossed Out One of the Trump Campaign's PA Lawsuits	1
t3_jxz6rl	White Nationalist Appointed by Trump to Holocaust Commission Praised Jeffrey Epstein for Not Being “a Pussy”	U
t3_jyedlw	Biden team solicits donations to fund presidential transition as Trump administration blocks federal money	"3,4"
t3_k034z9	The Trump administration may privatize Fannie Mae and Freddie Mac — and it could disrupt the nation’s housing-finance system	4
t3_jz2tha	"Trump obsession: Democrats tweet about him 12,569 times to 486 about Biden"	U
t3_jyj7a6	Michigan Democrats are taking a stand against Trump's campaign to steal the state's vote	1
t3_jzq0dh	Biden’s Europe challenge: Repair tattered transatlantic ties | Four years of Donald Trump have done serious damage to mutual trust.	5
t3_k0dlh2	Trump's DOJ Backs Down on Deporting Women Alleging ICE Gynecological Abuse	U
t3_jxrzlp	Obama Tells Jimmy Kimmel: 'We Can Always Send the Navy SEALS' to Remove Trump from White House	"3,7"
t3_k03198	Trump transition order follows chorus of GOP criticism	3
t3_jxtnp8	People who know Rudy Giuliani are shocked by what he’s become. People who know Trump say he’s terrifed	U
t3_jyo98b	Sen. Toomey congratulates Biden as president-elect after judge rules against Trump in Pa.	1
t3_jygbaz	GOP Michigan ex-governor says state board will certify Biden winner over 'bully' Trump	1
t3_jznz36	Did Trump Pardon a Turkey That 'Refused To Concede' an Election?	"1,5"
t3_jzp967	"General Motors Aligns With Biden, Pulls Out of Lawsuit Supporting Trump"	1
t3_jzh7ew	Carl Bernstein names 21 Republican senators who have ‘privately’ expressed ‘extreme contempt’ for Trump	7
t3_jxqenc	Trump's emotional state is 'quite fragile' after election loss	3
t3_jy834q	Trump Owned By Parody Twitter Account He Apparently Believed Was His Sister’s	U
t3_jzm6f8	Carl Bernstein names 21 GOP senators who privately express “contempt” for Trump but still enable him	7
t3_jya718	"Blocked by Trump, Biden forced to use transition workarounds"	3
t3_jzicmc	How Ronald Reagan’s Racism Helped Pave the Way for Donald Trump’s	U
t3_jzjwm1	Biden focuses on Cabinet as Trump's hopes of overturning election fade	1
t3_jzlnvy	A major Trump donor’s company got a 3 percent government-backed pandemic loan. It sells title loans at a 350 percent annual rate.	4
t3_jyjcxb	Wisconsin officials: Trump observers obstructing recount	1
t3_jz0nbc	Pressure grows from GOP for Trump to recognize Biden election win	1
t3_jxrln3	Hoyer on Trump election challenges: 'I think this borders on treason'	1
t3_jym9cn	Pennsylvania Judge Dismisses Trump Campaign's Challenge to Pennsylvania Election Law	1
t3_k0eyot	"Joseph Nye: ""Trump deserves credit for pushing back on China's abusive trade practices, but it would have been better if we worked with our allies to isolate China. Also, his trade deal has been costly for Americans without changing the trade imbalance or addressing technological issues."""	"4,5"
t3_jzlu2s	"All Republicans should support President Trump's legal fights -- Any who believe that buddying up to the Biden team is a symbol of unity, and better for America, have already abandoned Trump, conservatism, and America."	1
t3_jxdm04	"Lin Wood loses motion to stop certification, Trump vows to file another ‘major lawsuit’ against Georgia election"	1
t3_jyyaoi	"Trump Requests Georgia Recount, Meaning 5 Million Votes Will Be Tabulated A 3rd Time"	1
t3_jrrwjo	"Trump: We Are Making Big Progress, We Will Win"	1
t3_jzrwkf	Trump’s vote fraud claims draw continued scrutiny from Twitter	1
t3_k0fphc	Trump will soon leave the White House. How long before he stops dominating the conversation?	3
t3_jyz99e	Trump Lawyer Sidney Powell Promises 'Biblical' Lawsuit in Coming Days	1
t3_jxxelw	Trump Appears To Doubting Tucker And Lets Him Touch The Fraudulent Ballots Himself	1
t3_jzsh0c	Trump Lawyer: Michigan Legislature Agrees to Hold Election Review Hearings	1
t3_jxq0yf	Biden Must Keep His Word and Allow Investigations of Trump to Proceed	3
t3_jybzw2	Trump Organization's consulting payments to Ivanka Trump are focus of NY tax probe	4
t3_jz1a2t	"Trump Lawyer Sidney Powell Says Georgia Election Lawsuit 'Will Be Biblical,' Suggests GOP Governor Helped Biden"	1
t3_k0b0kz	Trump vows he’ll ‘never concede’ despite administration starting transition move	1
t3_jypw7q	"Out of 53 Republican senators, only two have stood up to Trump's attempt to overturn the election"	1
t3_jxogw4	"Trump lawyers filed a motion in Pennsylvania to clarify they only want to block the state from certifying results of the presidential elections, not any other races on the same ballot"	1
t3_jzlwhd	Trump appeals big loss in Pennsylvania vote case that seeks to block Biden win	1
t3_jzeqq0	Opinion | Why Biden should stop parsing words and call Trump's lies a coup	1
t3_k0c42y	Biden win over Trump in Nevada made official by court	1
t3_jzvf9k	Dr. Redlener: Trump’s denial of science has ‘poisoned’ this country	7
t3_jz404d	Team Trump offering 'fire hose' of conspiracy Kool-Aid for supporters	1
t3_jy9t3x	Biden will receive @POTUS Twitter account even if Trump refuses to concede	3
t3_jygoog	Trump voters back the President’s charges of election fraud led by Democrats	1
t3_k0beyi	Donald Trump stands up for the Confederacy one last time	U
t3_jxze94	Ivanka Trump distances self from dad’s election fraud claims as her own legal jeopardy grows	1
t3_jybv6o	Will Trump Screw Up Republican Efforts to Hang Onto the Senate?	7
t3_jywgwe	Republican senator congratulates Biden telling Trump to ‘accept outcome of election’	"1,3"
t3_jz7o2y	Giuliani releases statement distancing Trump campaign from lawyer Sidney Powell	"1,2"
t3_jzukkw	"Almost no Trump voters consider Biden the legitimate 2020 election winner, poll says"	1
t3_jzv491	Reince Priebus reacts to Wis. Dems' rule-change try following Trump recount filing: ‘You can’t make this up!'	1
t3_jyl2mf	Trump skipped a coronavirus meeting with G20 leaders to play golf	"2,5"
t3_k00kt2	Whoopi Goldberg calls out ‘dictator’ Trump for staging ‘coup’	"1,7"
t3_jzsfbe	Trump attorney in Wisconsin argues absentee votes should be thrown out - including his own	1
t3_jynkt5	Trump Skips G20 Session on Coronavirus Pandemic and Goes Golfing Instead	"2,5"
t3_jyk5l1	The Desperate Final Gasps of Team Trump’s Flailing ‘Mini-Coup’	1
t3_jz1vvt	"Patrick Buchanan: ""Is Trump Exiting Afghanistan -- to Attack Iran?"""	5
t3_jzv44u	Trump Supporter Charged with Simple Assault for Breathing on Protesters	U
t3_jzrztf	CEOs Urge Trump To Concede: 'Not A Moment To Waste' In Fighting COVID-19	"1,2"
t3_jzmtno	Tucker Carlson was attacked by Trump supporters for questioning the outlandish claims of the president's lawyer Sidney Powell before she was fired	1
t3_jysd13	Ben Carson Confirms Trump’s Friends Get Better Coronavirus Treatments	2
t3_jz2555	"In last-gasp maneuver, Trump campaign tries to invalidate thousands of votes as Wisconsin recount gets underway"	1
t3_jz7x4k	Trump campaign parts ways with Powell after vote-switching claim	1
t3_jzhgb0	'We've got your back' - Trump advisor vows U.S. support in South China Sea	5
t3_jyqowe	"Michiganders Erupt After Their Maskless Lawmakers Sip Dom Perignon At Trump Hotel - Michigan legislators celebrate together after secretive meeting with Trump, who has been plotting to overturn the state’s vote for Joe Biden."	1
t3_k0f3pm	"New Trump rule could require up to $15,000 bond for travel to US"	4
t3_k0bsrn	"Ivanka Trump called out for boasting about drop in greenhouse emissions: ""This is largely because of the pandemic"""	"2,6"
t3_jyf2se	"Georgia GOP governor says he understands Trump's frustration, but maintains he's following state laws"	1
t3_k05eu0	Trump lawsuit confuses Michigan and Minnesota locations in affidavit claiming voter fraud	1
t3_k0ddev	Nolte: Only 3% of Trump Voters Believe Joe Biden Is Legitimate Winner	1
t3_jz0vxg	Christie calls Trump's legal efforts a 'national embarrassment' as more Republicans speak out	1
t3_jyqoj0	Dr. Ben Carson: Trump Saved My Life After I Got COVID	2
t3_jzvws9	"Trump previewed his legal strategy 2 years ago, when he said a turkey 'refused to concede and demanded a recount'"	1
t3_jznypc	Trump campaign takes Pennsylvania election fight to federal appeals court	1
t3_jykgfn	Black Detroit voters sue Trump campaign over effort to invalidate election results	1
t3_jxy8cp	The Coup Stage of Donald Trump’s Presidency	1
t3_jyxn3r	Hogan 'embarrassed that more people' in the GOP 'aren't speaking up' against Trump	1
t3_jype7k	"Analysis: With silence, GOP enables Trump’s risky endgame"	1
t3_jy09dz	Opinion: Hold President Trump accountable for his misdeeds	7
t3_jzjgop	Open Letter Calls on Harvard to Create 'System of Accountability' for Inviting Trump Admin Alums to Campus	U
t3_jzt9rt	"Fearing turmoil, Wall Street ups pressure on Trump to quit"	1
t3_jzwige	PA Supreme Court rejects Trump challenge to absentee ballots in Allegheny County	1
t3_jyy5hi	"Trump, the Saboteur. First a Tantrum, Then Taking Every Opportunity to Trash Our Government"	1
t3_jy560y	More U.S. Congress Republicans openly doubt Trump's election claims	1
t3_jzrye4	Michigan votes to certify Biden's win over Trump	1
t3_jzji16	Trump's closest business ally just admitted that the president lost the election	1
t3_jz73xa	Judge Dismisses Trump Campaign's Bid To Delay Vote Certification In Pennsylvania	1
t3_jy3mi8	"Team Trump Leaders, Including Campaign Manager Bill Stepien, Have No Faith in Rudy"	1
t3_jzijpr	"Trump Pulls Out Of Military Transparency Treaty With Russia, Europe"	5
t3_jyuup3	Trump Wonders Why Joe Biden Is Forming A Cabinet In Latest Tweet Screed	3
t3_jzjlmh	Democrat House Losses Stemmed From Trump Increasing Voter Turnout: Rep. Richmond	U
t3_jxntgi	An anonymous group of top US CEOs said they would hold off acting against Trump until after the Georgia recount. It's done.	1
t3_jzuuec	Biden team wants to understand Trump effort to 'hollow out government agencies'	3
t3_jyv7ng	Spy Jonathan Pollard expected to fly to Israel after US lifts parole. Release marks latest gesture by departing Trump administration towards the Israeli government	5
t3_jys1yc	Trump’s tyranny is the moral equivalent of treason	"1,7"
t3_jy5154	A tragic farce: Trump's ignominious White House exit	3
t3_jzyv4s	Jenna Ellis insulted Trump and his supporters in 2016. The RINOs are on the inside.	7
t3_jz3i4z	Stop golfing and concede: Maryland GOP Governor Larry Hogan spars with Trump	"1,7"
t3_jzp6x0	"Marjorie Taylor Greene ""solidly convinced"" Trump won Georgia despite state certifying Biden's win"	1
t3_jzsmiy	Trump Fires Sidney Powell for Election Conspiracies as Though He’s Not About to Claim China Paid Poll Workers to Change All the Ballots to Biden	1
t3_jztjh2	National Embarrassment Donald Trump Worried Lawyers Are Sullying His Pristine Reputation	7
t3_jz22oq	Hogan ramps up criticism of Trump: 'Stop golfing and concede'	"1,7"
t3_jzgzo5	"Trump is not just refusing to concede, he is sabotaging nation’s interest"	1
t3_k0a3tb	Trump shares Randy Quaid video: 'Fox is dead to me'	U
t3_jycdqu	Why Can Trump Try To Steal The Election? Blame The Electoral College.	1
t3_jzrpbc	Trump campaign to ask appeals court to halt Biden win in Pennsylvania	1
t3_jz1nzm	National Review Slams Trump’s Refusal To Concede As ‘A Bid For Infamy’ — The conservative magazine condemned the baseless lawsuits and conspiracies of the Trump legal team as a “profoundly undemocratic gambit.”	1
t3_jyc5ef	Trump options narrow as Michigan backs Biden win	1
t3_jynt1e	Trump tells G20 leaders he wants to work with them ‘for a long time’	5
t3_k04vjz	Why Newsmax Supports Trump’s False Voter-Fraud Claims	1
t3_k0dq4l	White House reporters befuddled by brief Trump statement on stock market: 'Weird as s--t'	U
t3_jyevov	"Trump Supporters in Georgia Threaten to Destroy GOP, Boycott Runoff Elections"	1
t3_jzny0i	"Pennsylvania Republicans Voted Against Certifying Vote in County Trump Won by 22,000"	1
t3_jyih12	"Yes, Trump Is (Still) Engaged in an Attempted Coup; and Yes, It Might Lead to a Constitutional Crisis and a Breaking Point"	1
t3_jxsv1q	Trump Campaign Fact-Checks the Media: Georgia Has Not Certified Biden's Win	1
t3_jzruwz	General Motors’ parting shot at Trump bodes well for the Biden presidency	1
t3_jyoi1n	Trump has exhausted all plausible legal options: GOP Sen. Pat Toomey congratulates Biden	1
t3_jztxao	What Donald Trump Liked About Being President	U
t3_jyt5rw	Liz Cheney says Trump should respect ‘sanctity’ of election if he can’t prove claims in court	1
t3_jzst4r	"Trump fears Giuliani, other lawyers in Biden vote challenge are 'fools that are making him look bad'"	1
t3_jxztlz	The Trump campaign allegedly mixed up Michigan and Minnesota in its election lawsuit	1
t3_jzvyov	"Perdue, Loeffler Join Trump Call for New Georgia Recount"	1
t3_jybdm3	Trump Takes Another L: Michigan GOPers Say No To Election Steal	1
t3_jzjbng	In Another Country This Would Be Called a Coup: Detroit NAACP Head on Trump Trying to Overturn Vote	1
t3_jz3yzg	Pompeo says Mideast strategy will be Trump administration policy 'until our time is complete'	5
t3_jyobrs	"On Parler, a pro-Trump call for Georgia runoff boycott threatens Mitch McConnell's plan to restrain Biden"	3
t3_jybaah	"Rudy and Sidney’s Krakentastic Spectacle, and What It Could Mean -- A dismissive legacy media might have panned Team Trump’s press conference Thursday, but it was a significant moment with significant portents."	1
t3_jz7cd3	Trump’s campaign vows to appeal Pennsylvania lawsuit all the way to Supreme Court	1
t3_jzu2rx	"Michigan Certifies Election Results, Declaring Biden Winner In New Blow To Trump"	1
t3_k0djl7	Trump Insists He’s Still Going to Be President as White House Landlord Asks For Forwarding Address for Security Deposit	1
t3_jzskav	Pennsylvania Supreme Court Reverses One of Trump’s Only Post-Election Litigation Wins	1
t3_jz0akg	"Trump, GOP’s ridiculous, flailing coup isn’t a joke. It’s a crime. There must be consequences | Will Bunch"	1
t3_k04g1f	Why GOP Officeholders Tolerate Trump’s Election Antics	1
t3_jyevyz	Biden's popular vote lead over Trump stretches to more than 6m	1
t3_jyhkqu	Judge rules against Trump global media chief after firings	1
t3_jzi4lz	Trump Campaign Takes Aim At Nevada Native Vote Project	1
t3_jy46k6	Letters to the Editor: Stop Donald Trump's coup. Impeach him again	1
t3_jzpeei	Trump Is Blowing Up the Georgia GOP—and It Couldn’t Happen at a Better Time	U
t3_jztmee	Trump Responsible For Largest Rescue of American Hostages	5
t3_jyiop6	"Trump attacks big Pharma, announces programs to lower drug prices"	4
t3_jxkgvx	‘No Pardons. No Immunity’: Mary Trump Says Her Family Must Pay	7
t3_jz5ffr	Trump campaign says Sidney Powell not a member of legal team	1
t3_jxxjgh	"Giuliani, other Trump lawyers to skip meeting with Michigan lawmakers after COVID-19 exposure"	2
t3_jzjptq	Two-thirds of GOP voters support Trump running for president in 2024: survey	1
t3_jzwk4e	The Secret Service is reportedly preparing for Trump's 'post-presidency life'	3
t3_k07u3h	Trump has set a hidden trap for Biden. It could do great damage.	3
t3_jym704	Obama Appointed Federal Judge Dismisses Trump Campaign Lawsuit in Pennsylvania	1
t3_jxybf2	'Certify the Results!': Michigan Lawmakers Blasted for 'Legitimizing a Fascist Coup Attempt' by Meeting With Trump	1
t3_jz0c9x	Satire: CNN Condemns Trump Rallies As 'Physically Peaceful But Morally Violent'	1
t3_jz5f71	Julie Burchill: President Trump has loved and been great for Israel	5
t3_jydvyu	How Georgia's pro-Trump election chief became the bane of the GOP	U
t3_jzpllg	The Already Useless Trump Kids Are About to Get Even More So	7
t3_jygps8	Trump nominee's long road to Fed may be dead end	U
t3_jzkuz6	Trump Faces Growing Calls From Biz Leaders To Concede After Legal Battles Fall Flat	1
t3_jyfij4	"Georgia Gov. Kemp Calls for Audit, Says Trump Can Demand New Recount"	1
t3_k01a73	"After Chaotic 4 Years, Wall St. Is Itching to Unfollow @realDonaldTrump - President Trump turned his Twitter feed into a singular source of market volatility. Now, investors are looking forward to markets free of presidential tweets."	3
t3_jz265e	"Trump’s legal team cried vote fraud, but courts found none"	1
t3_jybvym	Biden's lead over Trump surpasses 6M votes as more ballots are tallied	1
t3_jyzpvt	"How Trump Responded When Liz Cheney Called on Him to Concede: ""Sorry Liz, can’t accept the results of an election with hundreds of thousands of fraudulent votes cast, enough to easily flip the Election. You’re just unhappy that I’m bringing the troops back home where they belong!"""	1
t3_jt1svc	Democrat Senator Joe Manchin tweets that Democrats do not want to defund the police and do not have a socialist agenda and AOC tweets a photo of herself glaring at him during a SOTU speech by Trump.	U
t3_jycft4	The Memo: Trump plows ahead with efforts to overturn election	1
t3_jz593p	'This Obama judge' is 'outrageous': Mark Levin blasts PA ruling dismissing Trump voter fraud challenge	1
t3_jzwb0o	Sidney Powell Undermined Georgia GOP During Crucial Senate Runoff Before Trump Campaign Cut Her Loose	1
t3_k08xyk	Democrats didn't refuse to acknowledge Trump’s 2016 victory	1
t3_jzi8g6	Trump’s legal team’s statement on Sydney Powell was made to focus on the upcoming Supreme Court case. There are two separate legal pathways. One on equal protection and PA voting rules (most important right now). The second is Dominion software which will take longer.	1
t3_jyserv	"Pennsylvania GOP Sen. Pat Toomey Tells Trump It's Over, Congratulates Joe Biden"	1
t3_jymov0	Trump Warns 'Massive Fraud' to Be Uncovered in Michigan Vote	1
t3_jzlvto	Trump threatens defense bill veto over renaming bases honoring Confederates	5
t3_jz9dqx	Lou Dobbs Warns the GOP: Republican Party ‘Will Be Gone and Done’ If They Don’t Stand With President Trump	1
t3_k08kqp	"The Damage Is the Point | Trump may not be able to extend his reign, but he can aid and abet his party by further curtailing the right to vote."	1
t3_jzgode	Trump axed campaign lawyer Sidney Powell was because 'she was too conspiratorial even for him'	1
t3_jynndi	Missing Links: Trump Goes Golfing In Middle Of G20 Summit	5
t3_jyaidt	The Danger (and Ineptitude) of Trump’s Failed Coup	1
t3_jyulqn	Trump Team Files for Fresh Recount in Georgia’s Presidential Race	1
t3_k0ape6	"Newsmax CEO Thinks Trump Should Concede When States Certify Elections, Would Support Overturning Electoral College"	1
t3_jz6si6	Sidney Powell: Trump legal team disavows lawyer who claimed Venezuelan communists helped rig US election	1
